jahr;gemeinde_nummer;gemeinde;bezirk_nummer;bezirk;versorgungsregion_code;versorgungsregion;versorgungsregion_aggriegiert_code;versorgungsregion_aggriegiert;anfangsbestand;geburten;todesfaelle;geburtenueberschuss;zuzuege;wegzuege;wanderungssaldo;bereinigung_saldo;gesamtveraenderung;endbestand
1980;2761;Aesch (BL);1301;Bezirk Arlesheim;3;VR Alter Birsstadt;3;VR Alter Birsstadt;7922;102;41;61;850;796;54;-72;43;7965
1980;2762;Allschwil;1301;Bezirk Arlesheim;1;VR Alter und Gesundheit ABS;1;VR Alter und Gesundheit ABS;18065;202;151;51;1449;1590;-141;-5;-95;17970
1980;2763;Arlesheim;1301;Bezirk Arlesheim;3;VR Alter Birsstadt;3;VR Alter Birsstadt;8421;88;69;19;784;801;-17;2;4;8425
1980;2764;Biel-Benken;1301;Bezirk Arlesheim;4;VR BPA Leimental;4;VR BPA Leimental;1894;17;11;6;182;147;35;-11;30;1924
1980;2765;Binningen;1301;Bezirk Arlesheim;1;VR Alter und Gesundheit ABS;1;VR Alter und Gesundheit ABS;14536;115;105;10;1544;1539;5;-89;-74;14462
1980;2766;Birsfelden;1301;Bezirk Arlesheim;2;VR APG Rheintal;2;VR APG Rheintal;13048;121;98;23;879;1120;-241;-3;-221;12827
1980;2767;Bottmingen;1301;Bezirk Arlesheim;4;VR BPA Leimental;4;VR BPA Leimental;4711;54;26;28;750;515;235;-72;191;4902
1980;2768;Ettingen;1301;Bezirk Arlesheim;4;VR BPA Leimental;4;VR BPA Leimental;3834;71;12;59;604;404;200;-37;222;4056
1980;2769;Münchenstein;1301;Bezirk Arlesheim;3;VR Alter Birsstadt;3;VR Alter Birsstadt;11181;102;90;12;834;1005;-171;1;-158;11023
1980;2770;Muttenz;1301;Bezirk Arlesheim;2;VR APG Rheintal;2;VR APG Rheintal;16952;176;111;65;1405;1417;-12;0;53;17005
1980;2771;Oberwil (BL);1301;Bezirk Arlesheim;4;VR BPA Leimental;4;VR BPA Leimental;7661;72;49;23;743;668;75;3;101;7762
1980;2772;Pfeffingen;1301;Bezirk Arlesheim;3;VR Alter Birsstadt;3;VR Alter Birsstadt;1252;7;4;3;132;87;45;0;48;1300
1980;2773;Reinach (BL);1301;Bezirk Arlesheim;3;VR Alter Birsstadt;3;VR Alter Birsstadt;17658;200;88;112;1703;1462;241;28;381;18039
1980;2774;Schönenbuch;1301;Bezirk Arlesheim;1;VR Alter und Gesundheit ABS;1;VR Alter und Gesundheit ABS;746;6;6;0;74;47;27;-5;22;768
1980;2775;Therwil;1301;Bezirk Arlesheim;4;VR BPA Leimental;4;VR BPA Leimental;7376;89;37;52;630;714;-84;-4;-36;7340
1980;2821;Arisdorf;1303;Bezirk Liestal;6;VR Alters- und Pflegeregion Liestal;6;VR Alters- und Pflegeregion Liestal;998;12;5;7;82;63;19;3;29;1027
1980;2822;Augst;1303;Bezirk Liestal;2;VR APG Rheintal;2;VR APG Rheintal;836;17;8;9;135;170;-35;4;-22;814
1980;2823;Bubendorf;1303;Bezirk Liestal;6;VR Alters- und Pflegeregion Liestal;6;VR Alters- und Pflegeregion Liestal;2174;28;17;11;251;199;52;2;65;2239
1980;2824;Frenkendorf;1303;Bezirk Liestal;6;VR Alters- und Pflegeregion Liestal;6;VR Alters- und Pflegeregion Liestal;5485;74;41;33;617;629;-12;-46;-25;5460
1980;2825;Füllinsdorf;1303;Bezirk Liestal;6;VR Alters- und Pflegeregion Liestal;6;VR Alters- und Pflegeregion Liestal;4134;53;20;33;334;411;-77;-37;-81;4053
1980;2826;Giebenach;1303;Bezirk Liestal;2;VR APG Rheintal;2;VR APG Rheintal;321;5;2;3;74;25;49;2;54;375
1980;2827;Hersberg;1303;Bezirk Liestal;6;VR Alters- und Pflegeregion Liestal;6;VR Alters- und Pflegeregion Liestal;234;1;1;0;12;13;-1;7;6;240
1980;2828;Lausen;1303;Bezirk Liestal;6;VR Alters- und Pflegeregion Liestal;6;VR Alters- und Pflegeregion Liestal;3417;57;27;30;377;346;31;15;76;3493
1980;2829;Liestal;1303;Bezirk Liestal;6;VR Alters- und Pflegeregion Liestal;6;VR Alters- und Pflegeregion Liestal;11667;131;95;36;1277;1351;-74;2;-36;11631
1980;2830;Lupsingen;1303;Bezirk Liestal;6;VR Alters- und Pflegeregion Liestal;6;VR Alters- und Pflegeregion Liestal;785;7;5;2;66;52;14;-1;15;800
1980;2831;Pratteln;1303;Bezirk Liestal;2;VR APG Rheintal;2;VR APG Rheintal;15573;207;81;126;1624;1657;-33;-6;87;15660
1980;2832;Ramlinsburg;1303;Bezirk Liestal;10;VR Waldenburgertal plus;8;VR Waldenburgertal plus;375;3;5;-2;26;31;-5;2;-5;370
1980;2833;Seltisberg;1303;Bezirk Liestal;6;VR Alters- und Pflegeregion Liestal;6;VR Alters- und Pflegeregion Liestal;858;9;4;5;67;43;24;23;52;910
1980;2834;Ziefen;1303;Bezirk Liestal;6;VR Alters- und Pflegeregion Liestal;6;VR Alters- und Pflegeregion Liestal;1001;9;7;2;55;74;-19;10;-7;994
1980;2841;Anwil;1304;Bezirk Sissach;9;VR Farnsberg plus;7;Planungsregion Oberbaselbiet;321;2;4;-2;19;31;-12;-3;-17;304
1980;2842;Böckten;1304;Bezirk Sissach;7;VR Oberbaselbiet;7;Planungsregion Oberbaselbiet;541;9;5;4;56;63;-7;4;1;542
1980;2843;Buckten;1304;Bezirk Sissach;8;VR Oberes Homburgertal;7;Planungsregion Oberbaselbiet;604;12;6;6;78;65;13;-16;3;607
1980;2844;Buus;1304;Bezirk Sissach;9;VR Farnsberg plus;7;Planungsregion Oberbaselbiet;741;6;5;1;60;74;-14;-2;-15;726
1980;2845;Diepflingen;1304;Bezirk Sissach;7;VR Oberbaselbiet;7;Planungsregion Oberbaselbiet;412;6;2;4;32;44;-12;-1;-9;403
1980;2846;Gelterkinden;1304;Bezirk Sissach;7;VR Oberbaselbiet;7;Planungsregion Oberbaselbiet;4961;67;32;35;395;408;-13;5;27;4988
1980;2847;Häfelfingen;1304;Bezirk Sissach;8;VR Oberes Homburgertal;7;Planungsregion Oberbaselbiet;217;1;3;-2;19;18;1;-5;-6;211
1980;2848;Hemmiken;1304;Bezirk Sissach;9;VR Farnsberg plus;7;Planungsregion Oberbaselbiet;247;1;1;0;11;8;3;-1;2;249
1980;2849;Itingen;1304;Bezirk Sissach;7;VR Oberbaselbiet;7;Planungsregion Oberbaselbiet;1113;9;10;-1;149;143;6;-19;-14;1099
1980;2850;Känerkinden;1304;Bezirk Sissach;8;VR Oberes Homburgertal;7;Planungsregion Oberbaselbiet;306;1;1;0;27;24;3;0;3;309
1980;2851;Kilchberg (BL);1304;Bezirk Sissach;9;VR Farnsberg plus;7;Planungsregion Oberbaselbiet;99;4;1;3;9;5;4;-1;6;105
1980;2852;Läufelfingen;1304;Bezirk Sissach;8;VR Oberes Homburgertal;7;Planungsregion Oberbaselbiet;1185;12;13;-1;115;116;-1;3;1;1186
1980;2853;Maisprach;1304;Bezirk Sissach;9;VR Farnsberg plus;7;Planungsregion Oberbaselbiet;547;5;8;-3;40;29;11;-2;6;553
1980;2854;Nusshof;1304;Bezirk Sissach;7;VR Oberbaselbiet;7;Planungsregion Oberbaselbiet;138;3;2;1;4;1;3;2;6;144
1980;2855;Oltingen;1304;Bezirk Sissach;9;VR Farnsberg plus;7;Planungsregion Oberbaselbiet;327;2;4;-2;18;8;10;-3;5;332
1980;2856;Ormalingen;1304;Bezirk Sissach;7;VR Oberbaselbiet;7;Planungsregion Oberbaselbiet;1315;17;7;10;101;72;29;-11;28;1343
1980;2857;Rickenbach (BL);1304;Bezirk Sissach;9;VR Farnsberg plus;7;Planungsregion Oberbaselbiet;364;4;4;0;37;23;14;-9;5;369
1980;2858;Rothenfluh;1304;Bezirk Sissach;9;VR Farnsberg plus;7;Planungsregion Oberbaselbiet;595;7;6;1;50;36;14;15;30;625
1980;2859;Rümlingen;1304;Bezirk Sissach;8;VR Oberes Homburgertal;7;Planungsregion Oberbaselbiet;341;5;4;1;33;15;18;-12;7;348
1980;2860;Rünenberg;1304;Bezirk Sissach;9;VR Farnsberg plus;7;Planungsregion Oberbaselbiet;475;8;7;1;31;16;15;2;18;493
1980;2861;Sissach;1304;Bezirk Sissach;7;VR Oberbaselbiet;7;Planungsregion Oberbaselbiet;4583;44;46;-2;390;363;27;3;28;4611
1980;2862;Tecknau;1304;Bezirk Sissach;7;VR Oberbaselbiet;7;Planungsregion Oberbaselbiet;663;9;5;4;67;66;1;-6;-1;662
1980;2863;Tenniken;1304;Bezirk Sissach;7;VR Oberbaselbiet;7;Planungsregion Oberbaselbiet;661;11;5;6;54;39;15;-2;19;680
1980;2864;Thürnen;1304;Bezirk Sissach;7;VR Oberbaselbiet;7;Planungsregion Oberbaselbiet;915;10;9;1;84;63;21;1;23;938
1980;2865;Wenslingen;1304;Bezirk Sissach;7;VR Oberbaselbiet;7;Planungsregion Oberbaselbiet;505;10;5;5;28;16;12;-6;11;516
1980;2866;Wintersingen;1304;Bezirk Sissach;9;VR Farnsberg plus;7;Planungsregion Oberbaselbiet;453;5;3;2;23;17;6;6;14;467
1980;2867;Wittinsburg;1304;Bezirk Sissach;7;VR Oberbaselbiet;7;Planungsregion Oberbaselbiet;239;2;1;1;22;16;6;2;9;248
1980;2868;Zeglingen;1304;Bezirk Sissach;9;VR Farnsberg plus;7;Planungsregion Oberbaselbiet;445;2;4;-2;35;26;9;3;10;455
1980;2869;Zunzgen;1304;Bezirk Sissach;7;VR Oberbaselbiet;7;Planungsregion Oberbaselbiet;1528;15;6;9;114;110;4;-1;12;1540
1980;2881;Arboldswil;1305;Bezirk Waldenburg;10;VR Waldenburgertal plus;8;VR Waldenburgertal plus;397;5;5;0;11;14;-3;6;3;400
1980;2882;Bennwil;1305;Bezirk Waldenburg;10;VR Waldenburgertal plus;8;VR Waldenburgertal plus;454;8;2;6;26;29;-3;2;5;459
1980;2883;Bretzwil;1305;Bezirk Waldenburg;10;VR Waldenburgertal plus;8;VR Waldenburgertal plus;668;5;6;-1;33;42;-9;3;-7;661
1980;2884;Diegten;1305;Bezirk Waldenburg;7;VR Oberbaselbiet;7;Planungsregion Oberbaselbiet;789;12;6;6;102;50;52;-1;57;846
1980;2885;Eptingen;1305;Bezirk Waldenburg;7;VR Oberbaselbiet;7;Planungsregion Oberbaselbiet;510;3;5;-2;32;30;2;2;2;512
1980;2886;Hölstein;1305;Bezirk Waldenburg;10;VR Waldenburgertal plus;8;VR Waldenburgertal plus;1429;9;6;3;163;102;61;14;78;1507
1980;2887;Lampenberg;1305;Bezirk Waldenburg;10;VR Waldenburgertal plus;8;VR Waldenburgertal plus;399;4;9;-5;16;5;11;-6;0;399
1980;2888;Langenbruck;1305;Bezirk Waldenburg;10;VR Waldenburgertal plus;8;VR Waldenburgertal plus;777;9;3;6;103;91;12;-18;0;777
1980;2889;Lauwil;1305;Bezirk Waldenburg;10;VR Waldenburgertal plus;8;VR Waldenburgertal plus;318;2;3;-1;22;20;2;0;1;319
1980;2890;Liedertswil;1305;Bezirk Waldenburg;10;VR Waldenburgertal plus;8;VR Waldenburgertal plus;127;2;1;1;12;12;0;5;6;133
1980;2891;Niederdorf;1305;Bezirk Waldenburg;10;VR Waldenburgertal plus;8;VR Waldenburgertal plus;1437;15;11;4;171;129;42;-23;23;1460
1980;2892;Oberdorf (BL);1305;Bezirk Waldenburg;10;VR Waldenburgertal plus;8;VR Waldenburgertal plus;1943;27;24;3;180;149;31;-3;31;1974
1980;2893;Reigoldswil;1305;Bezirk Waldenburg;10;VR Waldenburgertal plus;8;VR Waldenburgertal plus;1323;11;16;-5;115;58;57;-7;45;1368
1980;2894;Titterten;1305;Bezirk Waldenburg;10;VR Waldenburgertal plus;8;VR Waldenburgertal plus;318;2;6;-4;25;12;13;-1;8;326
1980;2895;Waldenburg;1305;Bezirk Waldenburg;10;VR Waldenburgertal plus;8;VR Waldenburgertal plus;1220;12;7;5;91;86;5;8;18;1238
1981;2761;Aesch (BL);1301;Bezirk Arlesheim;3;VR Alter Birsstadt;3;VR Alter Birsstadt;7965;103;48;55;718;769;-51;6;10;7975
1981;2762;Allschwil;1301;Bezirk Arlesheim;1;VR Alter und Gesundheit ABS;1;VR Alter und Gesundheit ABS;17970;189;135;54;1479;1492;-13;39;80;18050
1981;2763;Arlesheim;1301;Bezirk Arlesheim;3;VR Alter Birsstadt;3;VR Alter Birsstadt;8425;83;53;30;786;693;93;1;124;8549
1981;2764;Biel-Benken;1301;Bezirk Arlesheim;4;VR BPA Leimental;4;VR BPA Leimental;1924;18;12;6;152;102;50;-1;55;1979
1981;2765;Binningen;1301;Bezirk Arlesheim;1;VR Alter und Gesundheit ABS;1;VR Alter und Gesundheit ABS;14462;134;114;20;1542;1798;-256;0;-236;14226
1981;2766;Birsfelden;1301;Bezirk Arlesheim;2;VR APG Rheintal;2;VR APG Rheintal;12827;123;75;48;835;1048;-213;-1;-166;12661
1981;2767;Bottmingen;1301;Bezirk Arlesheim;4;VR BPA Leimental;4;VR BPA Leimental;4902;56;29;27;652;533;119;0;146;5048
1981;2768;Ettingen;1301;Bezirk Arlesheim;4;VR BPA Leimental;4;VR BPA Leimental;4056;51;19;32;555;424;131;0;163;4219
1981;2769;Münchenstein;1301;Bezirk Arlesheim;3;VR Alter Birsstadt;3;VR Alter Birsstadt;11023;102;97;5;881;936;-55;1;-49;10974
1981;2770;Muttenz;1301;Bezirk Arlesheim;2;VR APG Rheintal;2;VR APG Rheintal;17005;174;112;62;1248;1321;-73;-86;-97;16908
1981;2771;Oberwil (BL);1301;Bezirk Arlesheim;4;VR BPA Leimental;4;VR BPA Leimental;7762;64;50;14;657;703;-46;0;-32;7730
1981;2772;Pfeffingen;1301;Bezirk Arlesheim;3;VR Alter Birsstadt;3;VR Alter Birsstadt;1300;6;12;-6;95;80;15;0;9;1309
1981;2773;Reinach (BL);1301;Bezirk Arlesheim;3;VR Alter Birsstadt;3;VR Alter Birsstadt;18039;191;83;108;1506;1566;-60;2;50;18089
1981;2774;Schönenbuch;1301;Bezirk Arlesheim;1;VR Alter und Gesundheit ABS;1;VR Alter und Gesundheit ABS;768;5;2;3;63;53;10;0;13;781
1981;2775;Therwil;1301;Bezirk Arlesheim;4;VR BPA Leimental;4;VR BPA Leimental;7340;102;26;76;641;645;-4;2;74;7414
1981;2821;Arisdorf;1303;Bezirk Liestal;6;VR Alters- und Pflegeregion Liestal;6;VR Alters- und Pflegeregion Liestal;1027;12;6;6;72;63;9;0;15;1042
1981;2822;Augst;1303;Bezirk Liestal;2;VR APG Rheintal;2;VR APG Rheintal;814;2;11;-9;132;113;19;0;10;824
1981;2823;Bubendorf;1303;Bezirk Liestal;6;VR Alters- und Pflegeregion Liestal;6;VR Alters- und Pflegeregion Liestal;2239;24;18;6;226;188;38;-2;42;2281
1981;2824;Frenkendorf;1303;Bezirk Liestal;6;VR Alters- und Pflegeregion Liestal;6;VR Alters- und Pflegeregion Liestal;5460;75;33;42;654;613;41;2;85;5545
1981;2825;Füllinsdorf;1303;Bezirk Liestal;6;VR Alters- und Pflegeregion Liestal;6;VR Alters- und Pflegeregion Liestal;4053;47;15;32;461;460;1;0;33;4086
1981;2826;Giebenach;1303;Bezirk Liestal;2;VR APG Rheintal;2;VR APG Rheintal;375;4;2;2;55;23;32;0;34;409
1981;2827;Hersberg;1303;Bezirk Liestal;6;VR Alters- und Pflegeregion Liestal;6;VR Alters- und Pflegeregion Liestal;240;3;0;3;10;7;3;1;7;247
1981;2828;Lausen;1303;Bezirk Liestal;6;VR Alters- und Pflegeregion Liestal;6;VR Alters- und Pflegeregion Liestal;3493;38;23;15;364;322;42;1;58;3551
1981;2829;Liestal;1303;Bezirk Liestal;6;VR Alters- und Pflegeregion Liestal;6;VR Alters- und Pflegeregion Liestal;11631;162;92;70;1351;1383;-32;1;39;11670
1981;2830;Lupsingen;1303;Bezirk Liestal;6;VR Alters- und Pflegeregion Liestal;6;VR Alters- und Pflegeregion Liestal;800;9;7;2;86;41;45;-1;46;846
1981;2831;Pratteln;1303;Bezirk Liestal;2;VR APG Rheintal;2;VR APG Rheintal;15660;167;100;67;1522;1689;-167;0;-100;15560
1981;2832;Ramlinsburg;1303;Bezirk Liestal;10;VR Waldenburgertal plus;8;VR Waldenburgertal plus;370;5;5;0;20;19;1;0;1;371
1981;2833;Seltisberg;1303;Bezirk Liestal;6;VR Alters- und Pflegeregion Liestal;6;VR Alters- und Pflegeregion Liestal;910;8;4;4;72;41;31;0;35;945
1981;2834;Ziefen;1303;Bezirk Liestal;6;VR Alters- und Pflegeregion Liestal;6;VR Alters- und Pflegeregion Liestal;994;12;11;1;62;65;-3;0;-2;992
1981;2841;Anwil;1304;Bezirk Sissach;9;VR Farnsberg plus;7;Planungsregion Oberbaselbiet;304;2;3;-1;31;15;16;0;15;319
1981;2842;Böckten;1304;Bezirk Sissach;7;VR Oberbaselbiet;7;Planungsregion Oberbaselbiet;542;6;5;1;63;73;-10;0;-9;533
1981;2843;Buckten;1304;Bezirk Sissach;8;VR Oberes Homburgertal;7;Planungsregion Oberbaselbiet;607;4;6;-2;64;47;17;0;15;622
1981;2844;Buus;1304;Bezirk Sissach;9;VR Farnsberg plus;7;Planungsregion Oberbaselbiet;726;9;12;-3;40;26;14;0;11;737
1981;2845;Diepflingen;1304;Bezirk Sissach;7;VR Oberbaselbiet;7;Planungsregion Oberbaselbiet;403;6;3;3;44;41;3;0;6;409
1981;2846;Gelterkinden;1304;Bezirk Sissach;7;VR Oberbaselbiet;7;Planungsregion Oberbaselbiet;4988;48;46;2;440;369;71;0;73;5061
1981;2847;Häfelfingen;1304;Bezirk Sissach;8;VR Oberes Homburgertal;7;Planungsregion Oberbaselbiet;211;3;2;1;27;21;6;0;7;218
1981;2848;Hemmiken;1304;Bezirk Sissach;9;VR Farnsberg plus;7;Planungsregion Oberbaselbiet;249;2;3;-1;14;13;1;0;0;249
1981;2849;Itingen;1304;Bezirk Sissach;7;VR Oberbaselbiet;7;Planungsregion Oberbaselbiet;1099;14;15;-1;154;144;10;1;10;1109
1981;2850;Känerkinden;1304;Bezirk Sissach;8;VR Oberes Homburgertal;7;Planungsregion Oberbaselbiet;309;4;3;1;41;30;11;0;12;321
1981;2851;Kilchberg (BL);1304;Bezirk Sissach;9;VR Farnsberg plus;7;Planungsregion Oberbaselbiet;105;2;0;2;14;14;0;0;2;107
1981;2852;Läufelfingen;1304;Bezirk Sissach;8;VR Oberes Homburgertal;7;Planungsregion Oberbaselbiet;1186;28;6;22;135;132;3;0;25;1211
1981;2853;Maisprach;1304;Bezirk Sissach;9;VR Farnsberg plus;7;Planungsregion Oberbaselbiet;553;9;5;4;38;31;7;0;11;564
1981;2854;Nusshof;1304;Bezirk Sissach;7;VR Oberbaselbiet;7;Planungsregion Oberbaselbiet;144;1;3;-2;16;5;11;0;9;153
1981;2855;Oltingen;1304;Bezirk Sissach;9;VR Farnsberg plus;7;Planungsregion Oberbaselbiet;332;6;3;3;8;11;-3;0;0;332
1981;2856;Ormalingen;1304;Bezirk Sissach;7;VR Oberbaselbiet;7;Planungsregion Oberbaselbiet;1343;15;7;8;67;78;-11;0;-3;1340
1981;2857;Rickenbach (BL);1304;Bezirk Sissach;9;VR Farnsberg plus;7;Planungsregion Oberbaselbiet;369;4;4;0;16;19;-3;0;-3;366
1981;2858;Rothenfluh;1304;Bezirk Sissach;9;VR Farnsberg plus;7;Planungsregion Oberbaselbiet;625;8;1;7;23;23;0;0;7;632
1981;2859;Rümlingen;1304;Bezirk Sissach;8;VR Oberes Homburgertal;7;Planungsregion Oberbaselbiet;348;3;7;-4;35;30;5;0;1;349
1981;2860;Rünenberg;1304;Bezirk Sissach;9;VR Farnsberg plus;7;Planungsregion Oberbaselbiet;493;4;6;-2;40;18;22;0;20;513
1981;2861;Sissach;1304;Bezirk Sissach;7;VR Oberbaselbiet;7;Planungsregion Oberbaselbiet;4611;53;43;10;396;386;10;-5;15;4626
1981;2862;Tecknau;1304;Bezirk Sissach;7;VR Oberbaselbiet;7;Planungsregion Oberbaselbiet;662;12;6;6;137;118;19;1;26;688
1981;2863;Tenniken;1304;Bezirk Sissach;7;VR Oberbaselbiet;7;Planungsregion Oberbaselbiet;680;7;4;3;35;35;0;0;3;683
1981;2864;Thürnen;1304;Bezirk Sissach;7;VR Oberbaselbiet;7;Planungsregion Oberbaselbiet;938;8;7;1;94;84;10;0;11;949
1981;2865;Wenslingen;1304;Bezirk Sissach;7;VR Oberbaselbiet;7;Planungsregion Oberbaselbiet;516;6;4;2;32;16;16;0;18;534
1981;2866;Wintersingen;1304;Bezirk Sissach;9;VR Farnsberg plus;7;Planungsregion Oberbaselbiet;467;4;3;1;21;22;-1;0;0;467
1981;2867;Wittinsburg;1304;Bezirk Sissach;7;VR Oberbaselbiet;7;Planungsregion Oberbaselbiet;248;2;2;0;18;18;0;0;0;248
1981;2868;Zeglingen;1304;Bezirk Sissach;9;VR Farnsberg plus;7;Planungsregion Oberbaselbiet;455;10;6;4;23;28;-5;0;-1;454
1981;2869;Zunzgen;1304;Bezirk Sissach;7;VR Oberbaselbiet;7;Planungsregion Oberbaselbiet;1540;17;17;0;159;143;16;0;16;1556
1981;2881;Arboldswil;1305;Bezirk Waldenburg;10;VR Waldenburgertal plus;8;VR Waldenburgertal plus;400;8;5;3;24;17;7;0;10;410
1981;2882;Bennwil;1305;Bezirk Waldenburg;10;VR Waldenburgertal plus;8;VR Waldenburgertal plus;459;2;2;0;15;14;1;0;1;460
1981;2883;Bretzwil;1305;Bezirk Waldenburg;10;VR Waldenburgertal plus;8;VR Waldenburgertal plus;661;5;5;0;42;24;18;0;18;679
1981;2884;Diegten;1305;Bezirk Waldenburg;7;VR Oberbaselbiet;7;Planungsregion Oberbaselbiet;846;11;3;8;90;63;27;0;35;881
1981;2885;Eptingen;1305;Bezirk Waldenburg;7;VR Oberbaselbiet;7;Planungsregion Oberbaselbiet;512;5;10;-5;36;31;5;0;0;512
1981;2886;Hölstein;1305;Bezirk Waldenburg;10;VR Waldenburgertal plus;8;VR Waldenburgertal plus;1507;21;11;10;121;101;20;0;30;1537
1981;2887;Lampenberg;1305;Bezirk Waldenburg;10;VR Waldenburgertal plus;8;VR Waldenburgertal plus;399;7;6;1;20;14;6;3;10;409
1981;2888;Langenbruck;1305;Bezirk Waldenburg;10;VR Waldenburgertal plus;8;VR Waldenburgertal plus;777;13;6;7;121;95;26;0;33;810
1981;2889;Lauwil;1305;Bezirk Waldenburg;10;VR Waldenburgertal plus;8;VR Waldenburgertal plus;319;3;4;-1;2;6;-4;0;-5;314
1981;2890;Liedertswil;1305;Bezirk Waldenburg;10;VR Waldenburgertal plus;8;VR Waldenburgertal plus;133;1;0;1;9;13;-4;0;-3;130
1981;2891;Niederdorf;1305;Bezirk Waldenburg;10;VR Waldenburgertal plus;8;VR Waldenburgertal plus;1460;11;8;3;134;111;23;0;26;1486
1981;2892;Oberdorf (BL);1305;Bezirk Waldenburg;10;VR Waldenburgertal plus;8;VR Waldenburgertal plus;1974;24;10;14;136;143;-7;0;7;1981
1981;2893;Reigoldswil;1305;Bezirk Waldenburg;10;VR Waldenburgertal plus;8;VR Waldenburgertal plus;1368;13;16;-3;94;81;13;0;10;1378
1981;2894;Titterten;1305;Bezirk Waldenburg;10;VR Waldenburgertal plus;8;VR Waldenburgertal plus;326;6;1;5;22;12;10;0;15;341
1981;2895;Waldenburg;1305;Bezirk Waldenburg;10;VR Waldenburgertal plus;8;VR Waldenburgertal plus;1238;10;15;-5;95;100;-5;0;-10;1228
1982;2761;Aesch (BL);1301;Bezirk Arlesheim;3;VR Alter Birsstadt;3;VR Alter Birsstadt;7975;105;45;60;941;727;214;1;275;8250
1982;2762;Allschwil;1301;Bezirk Arlesheim;1;VR Alter und Gesundheit ABS;1;VR Alter und Gesundheit ABS;18050;220;163;57;1385;1321;64;-1;120;18170
1982;2763;Arlesheim;1301;Bezirk Arlesheim;3;VR Alter Birsstadt;3;VR Alter Birsstadt;8549;89;73;16;625;601;24;2;42;8591
1982;2764;Biel-Benken;1301;Bezirk Arlesheim;4;VR BPA Leimental;4;VR BPA Leimental;1979;19;10;9;165;117;48;0;57;2036
1982;2765;Binningen;1301;Bezirk Arlesheim;1;VR Alter und Gesundheit ABS;1;VR Alter und Gesundheit ABS;14226;122;113;9;1415;1543;-128;-3;-122;14104
1982;2766;Birsfelden;1301;Bezirk Arlesheim;2;VR APG Rheintal;2;VR APG Rheintal;12661;114;91;23;842;1073;-231;1;-207;12454
1982;2767;Bottmingen;1301;Bezirk Arlesheim;4;VR BPA Leimental;4;VR BPA Leimental;5048;48;18;30;488;437;51;0;81;5129
1982;2768;Ettingen;1301;Bezirk Arlesheim;4;VR BPA Leimental;4;VR BPA Leimental;4219;61;20;41;416;380;36;1;78;4297
1982;2769;Münchenstein;1301;Bezirk Arlesheim;3;VR Alter Birsstadt;3;VR Alter Birsstadt;10974;103;90;13;855;873;-18;4;-1;10973
1982;2770;Muttenz;1301;Bezirk Arlesheim;2;VR APG Rheintal;2;VR APG Rheintal;16908;168;108;60;1441;1257;184;5;249;17157
1982;2771;Oberwil (BL);1301;Bezirk Arlesheim;4;VR BPA Leimental;4;VR BPA Leimental;7730;66;40;26;604;519;85;0;111;7841
1982;2772;Pfeffingen;1301;Bezirk Arlesheim;3;VR Alter Birsstadt;3;VR Alter Birsstadt;1309;13;4;9;141;98;43;0;52;1361
1982;2773;Reinach (BL);1301;Bezirk Arlesheim;3;VR Alter Birsstadt;3;VR Alter Birsstadt;18089;198;97;101;1339;1532;-193;5;-87;18002
1982;2774;Schönenbuch;1301;Bezirk Arlesheim;1;VR Alter und Gesundheit ABS;1;VR Alter und Gesundheit ABS;781;6;4;2;97;32;65;0;67;848
1982;2775;Therwil;1301;Bezirk Arlesheim;4;VR BPA Leimental;4;VR BPA Leimental;7414;109;33;76;632;553;79;0;155;7569
1982;2821;Arisdorf;1303;Bezirk Liestal;6;VR Alters- und Pflegeregion Liestal;6;VR Alters- und Pflegeregion Liestal;1042;6;8;-2;70;69;1;0;-1;1041
1982;2822;Augst;1303;Bezirk Liestal;2;VR APG Rheintal;2;VR APG Rheintal;824;16;3;13;134;141;-7;0;6;830
1982;2823;Bubendorf;1303;Bezirk Liestal;6;VR Alters- und Pflegeregion Liestal;6;VR Alters- und Pflegeregion Liestal;2281;30;7;23;263;230;33;0;56;2337
1982;2824;Frenkendorf;1303;Bezirk Liestal;6;VR Alters- und Pflegeregion Liestal;6;VR Alters- und Pflegeregion Liestal;5545;93;27;66;605;588;17;0;83;5628
1982;2825;Füllinsdorf;1303;Bezirk Liestal;6;VR Alters- und Pflegeregion Liestal;6;VR Alters- und Pflegeregion Liestal;4086;54;19;35;376;391;-15;0;20;4106
1982;2826;Giebenach;1303;Bezirk Liestal;2;VR APG Rheintal;2;VR APG Rheintal;409;6;1;5;42;38;4;0;9;418
1982;2827;Hersberg;1303;Bezirk Liestal;6;VR Alters- und Pflegeregion Liestal;6;VR Alters- und Pflegeregion Liestal;247;3;1;2;21;5;16;0;18;265
1982;2828;Lausen;1303;Bezirk Liestal;6;VR Alters- und Pflegeregion Liestal;6;VR Alters- und Pflegeregion Liestal;3551;65;22;43;334;329;5;0;48;3599
1982;2829;Liestal;1303;Bezirk Liestal;6;VR Alters- und Pflegeregion Liestal;6;VR Alters- und Pflegeregion Liestal;11670;161;97;64;1113;1376;-263;2;-197;11473
1982;2830;Lupsingen;1303;Bezirk Liestal;6;VR Alters- und Pflegeregion Liestal;6;VR Alters- und Pflegeregion Liestal;846;5;2;3;67;55;12;0;15;861
1982;2831;Pratteln;1303;Bezirk Liestal;2;VR APG Rheintal;2;VR APG Rheintal;15560;227;81;146;1386;1551;-165;0;-19;15541
1982;2832;Ramlinsburg;1303;Bezirk Liestal;10;VR Waldenburgertal plus;8;VR Waldenburgertal plus;371;3;2;1;22;28;-6;0;-5;366
1982;2833;Seltisberg;1303;Bezirk Liestal;6;VR Alters- und Pflegeregion Liestal;6;VR Alters- und Pflegeregion Liestal;945;8;8;0;55;52;3;0;3;948
1982;2834;Ziefen;1303;Bezirk Liestal;6;VR Alters- und Pflegeregion Liestal;6;VR Alters- und Pflegeregion Liestal;992;11;11;0;67;54;13;0;13;1005
1982;2841;Anwil;1304;Bezirk Sissach;9;VR Farnsberg plus;7;Planungsregion Oberbaselbiet;319;3;2;1;20;21;-1;0;0;319
1982;2842;Böckten;1304;Bezirk Sissach;7;VR Oberbaselbiet;7;Planungsregion Oberbaselbiet;533;7;5;2;57;56;1;0;3;536
1982;2843;Buckten;1304;Bezirk Sissach;8;VR Oberes Homburgertal;7;Planungsregion Oberbaselbiet;622;9;4;5;35;35;0;0;5;627
1982;2844;Buus;1304;Bezirk Sissach;9;VR Farnsberg plus;7;Planungsregion Oberbaselbiet;737;9;8;1;40;46;-6;0;-5;732
1982;2845;Diepflingen;1304;Bezirk Sissach;7;VR Oberbaselbiet;7;Planungsregion Oberbaselbiet;409;7;2;5;46;32;14;0;19;428
1982;2846;Gelterkinden;1304;Bezirk Sissach;7;VR Oberbaselbiet;7;Planungsregion Oberbaselbiet;5061;67;35;32;406;435;-29;0;3;5064
1982;2847;Häfelfingen;1304;Bezirk Sissach;8;VR Oberes Homburgertal;7;Planungsregion Oberbaselbiet;218;1;0;1;11;15;-4;0;-3;215
1982;2848;Hemmiken;1304;Bezirk Sissach;9;VR Farnsberg plus;7;Planungsregion Oberbaselbiet;249;5;2;3;20;17;3;0;6;255
1982;2849;Itingen;1304;Bezirk Sissach;7;VR Oberbaselbiet;7;Planungsregion Oberbaselbiet;1109;14;3;11;171;124;47;0;58;1167
1982;2850;Känerkinden;1304;Bezirk Sissach;8;VR Oberes Homburgertal;7;Planungsregion Oberbaselbiet;321;4;3;1;29;20;9;0;10;331
1982;2851;Kilchberg (BL);1304;Bezirk Sissach;9;VR Farnsberg plus;7;Planungsregion Oberbaselbiet;107;2;1;1;13;8;5;0;6;113
1982;2852;Läufelfingen;1304;Bezirk Sissach;8;VR Oberes Homburgertal;7;Planungsregion Oberbaselbiet;1211;21;13;8;120;105;15;-1;22;1233
1982;2853;Maisprach;1304;Bezirk Sissach;9;VR Farnsberg plus;7;Planungsregion Oberbaselbiet;564;7;6;1;49;36;13;0;14;578
1982;2854;Nusshof;1304;Bezirk Sissach;7;VR Oberbaselbiet;7;Planungsregion Oberbaselbiet;153;2;0;2;0;1;-1;0;1;154
1982;2855;Oltingen;1304;Bezirk Sissach;9;VR Farnsberg plus;7;Planungsregion Oberbaselbiet;332;5;3;2;16;16;0;0;2;334
1982;2856;Ormalingen;1304;Bezirk Sissach;7;VR Oberbaselbiet;7;Planungsregion Oberbaselbiet;1340;14;12;2;104;94;10;0;12;1352
1982;2857;Rickenbach (BL);1304;Bezirk Sissach;9;VR Farnsberg plus;7;Planungsregion Oberbaselbiet;366;4;2;2;17;16;1;0;3;369
1982;2858;Rothenfluh;1304;Bezirk Sissach;9;VR Farnsberg plus;7;Planungsregion Oberbaselbiet;632;6;4;2;55;49;6;0;8;640
1982;2859;Rümlingen;1304;Bezirk Sissach;8;VR Oberes Homburgertal;7;Planungsregion Oberbaselbiet;349;4;2;2;42;59;-17;0;-15;334
1982;2860;Rünenberg;1304;Bezirk Sissach;9;VR Farnsberg plus;7;Planungsregion Oberbaselbiet;513;4;3;1;26;22;4;0;5;518
1982;2861;Sissach;1304;Bezirk Sissach;7;VR Oberbaselbiet;7;Planungsregion Oberbaselbiet;4626;52;30;22;379;381;-2;0;20;4646
1982;2862;Tecknau;1304;Bezirk Sissach;7;VR Oberbaselbiet;7;Planungsregion Oberbaselbiet;688;17;5;12;121;101;20;0;32;720
1982;2863;Tenniken;1304;Bezirk Sissach;7;VR Oberbaselbiet;7;Planungsregion Oberbaselbiet;683;12;3;9;73;53;20;0;29;712
1982;2864;Thürnen;1304;Bezirk Sissach;7;VR Oberbaselbiet;7;Planungsregion Oberbaselbiet;949;20;4;16;84;81;3;0;19;968
1982;2865;Wenslingen;1304;Bezirk Sissach;7;VR Oberbaselbiet;7;Planungsregion Oberbaselbiet;534;6;5;1;34;28;6;0;7;541
1982;2866;Wintersingen;1304;Bezirk Sissach;9;VR Farnsberg plus;7;Planungsregion Oberbaselbiet;467;1;5;-4;10;20;-10;0;-14;453
1982;2867;Wittinsburg;1304;Bezirk Sissach;7;VR Oberbaselbiet;7;Planungsregion Oberbaselbiet;248;1;2;-1;20;29;-9;0;-10;238
1982;2868;Zeglingen;1304;Bezirk Sissach;9;VR Farnsberg plus;7;Planungsregion Oberbaselbiet;454;5;4;1;24;28;-4;0;-3;451
1982;2869;Zunzgen;1304;Bezirk Sissach;7;VR Oberbaselbiet;7;Planungsregion Oberbaselbiet;1556;18;19;-1;137;124;13;2;14;1570
1982;2881;Arboldswil;1305;Bezirk Waldenburg;10;VR Waldenburgertal plus;8;VR Waldenburgertal plus;410;5;3;2;12;18;-6;0;-4;406
1982;2882;Bennwil;1305;Bezirk Waldenburg;10;VR Waldenburgertal plus;8;VR Waldenburgertal plus;460;5;8;-3;22;26;-4;0;-7;453
1982;2883;Bretzwil;1305;Bezirk Waldenburg;10;VR Waldenburgertal plus;8;VR Waldenburgertal plus;679;8;4;4;29;31;-2;0;2;681
1982;2884;Diegten;1305;Bezirk Waldenburg;7;VR Oberbaselbiet;7;Planungsregion Oberbaselbiet;881;15;9;6;103;64;39;0;45;926
1982;2885;Eptingen;1305;Bezirk Waldenburg;7;VR Oberbaselbiet;7;Planungsregion Oberbaselbiet;512;11;5;6;37;27;10;0;16;528
1982;2886;Hölstein;1305;Bezirk Waldenburg;10;VR Waldenburgertal plus;8;VR Waldenburgertal plus;1537;26;12;14;161;124;37;1;52;1589
1982;2887;Lampenberg;1305;Bezirk Waldenburg;10;VR Waldenburgertal plus;8;VR Waldenburgertal plus;409;3;2;1;24;10;14;0;15;424
1982;2888;Langenbruck;1305;Bezirk Waldenburg;10;VR Waldenburgertal plus;8;VR Waldenburgertal plus;810;11;3;8;116;104;12;0;20;830
1982;2889;Lauwil;1305;Bezirk Waldenburg;10;VR Waldenburgertal plus;8;VR Waldenburgertal plus;314;3;3;0;14;12;2;0;2;316
1982;2890;Liedertswil;1305;Bezirk Waldenburg;10;VR Waldenburgertal plus;8;VR Waldenburgertal plus;130;1;0;1;18;2;16;0;17;147
1982;2891;Niederdorf;1305;Bezirk Waldenburg;10;VR Waldenburgertal plus;8;VR Waldenburgertal plus;1486;25;9;16;121;113;8;0;24;1510
1982;2892;Oberdorf (BL);1305;Bezirk Waldenburg;10;VR Waldenburgertal plus;8;VR Waldenburgertal plus;1981;18;10;8;115;155;-40;1;-31;1950
1982;2893;Reigoldswil;1305;Bezirk Waldenburg;10;VR Waldenburgertal plus;8;VR Waldenburgertal plus;1378;6;11;-5;85;91;-6;3;-8;1370
1982;2894;Titterten;1305;Bezirk Waldenburg;10;VR Waldenburgertal plus;8;VR Waldenburgertal plus;341;1;2;-1;18;15;3;0;2;343
1982;2895;Waldenburg;1305;Bezirk Waldenburg;10;VR Waldenburgertal plus;8;VR Waldenburgertal plus;1228;15;12;3;96;105;-9;0;-6;1222
1983;2761;Aesch (BL);1301;Bezirk Arlesheim;3;VR Alter Birsstadt;3;VR Alter Birsstadt;8250;132;42;90;801;679;122;1;213;8463
1983;2762;Allschwil;1301;Bezirk Arlesheim;1;VR Alter und Gesundheit ABS;1;VR Alter und Gesundheit ABS;18170;209;151;58;1463;1359;104;2;164;18334
1983;2763;Arlesheim;1301;Bezirk Arlesheim;3;VR Alter Birsstadt;3;VR Alter Birsstadt;8591;88;78;10;890;975;-85;6;-69;8522
1983;2764;Biel-Benken;1301;Bezirk Arlesheim;4;VR BPA Leimental;4;VR BPA Leimental;2036;19;12;7;141;122;19;0;26;2062
1983;2765;Binningen;1301;Bezirk Arlesheim;1;VR Alter und Gesundheit ABS;1;VR Alter und Gesundheit ABS;14104;152;122;30;1252;1352;-100;1;-69;14035
1983;2766;Birsfelden;1301;Bezirk Arlesheim;2;VR APG Rheintal;2;VR APG Rheintal;12454;114;88;26;881;990;-109;0;-83;12371
1983;2767;Bottmingen;1301;Bezirk Arlesheim;4;VR BPA Leimental;4;VR BPA Leimental;5129;48;22;26;511;469;42;0;68;5197
1983;2768;Ettingen;1301;Bezirk Arlesheim;4;VR BPA Leimental;4;VR BPA Leimental;4297;60;14;46;397;357;40;0;86;4383
1983;2769;Münchenstein;1301;Bezirk Arlesheim;3;VR Alter Birsstadt;3;VR Alter Birsstadt;10973;129;85;44;1000;861;139;0;183;11156
1983;2770;Muttenz;1301;Bezirk Arlesheim;2;VR APG Rheintal;2;VR APG Rheintal;17157;169;130;39;1009;1053;-44;0;-5;17152
1983;2771;Oberwil (BL);1301;Bezirk Arlesheim;4;VR BPA Leimental;4;VR BPA Leimental;7841;66;34;32;846;757;89;0;121;7962
1983;2772;Pfeffingen;1301;Bezirk Arlesheim;3;VR Alter Birsstadt;3;VR Alter Birsstadt;1361;14;4;10;129;101;28;0;38;1399
1983;2773;Reinach (BL);1301;Bezirk Arlesheim;3;VR Alter Birsstadt;3;VR Alter Birsstadt;18002;181;89;92;1206;1281;-75;0;17;18019
1983;2774;Schönenbuch;1301;Bezirk Arlesheim;1;VR Alter und Gesundheit ABS;1;VR Alter und Gesundheit ABS;848;10;4;6;78;48;30;0;36;884
1983;2775;Therwil;1301;Bezirk Arlesheim;4;VR BPA Leimental;4;VR BPA Leimental;7569;80;31;49;489;577;-88;0;-39;7530
1983;2821;Arisdorf;1303;Bezirk Liestal;6;VR Alters- und Pflegeregion Liestal;6;VR Alters- und Pflegeregion Liestal;1041;9;9;0;84;72;12;0;12;1053
1983;2822;Augst;1303;Bezirk Liestal;2;VR APG Rheintal;2;VR APG Rheintal;830;9;6;3;128;103;25;0;28;858
1983;2823;Bubendorf;1303;Bezirk Liestal;6;VR Alters- und Pflegeregion Liestal;6;VR Alters- und Pflegeregion Liestal;2337;25;15;10;219;147;72;0;82;2419
1983;2824;Frenkendorf;1303;Bezirk Liestal;6;VR Alters- und Pflegeregion Liestal;6;VR Alters- und Pflegeregion Liestal;5628;75;39;36;491;555;-64;0;-28;5600
1983;2825;Füllinsdorf;1303;Bezirk Liestal;6;VR Alters- und Pflegeregion Liestal;6;VR Alters- und Pflegeregion Liestal;4106;51;26;25;344;367;-23;0;2;4108
1983;2826;Giebenach;1303;Bezirk Liestal;2;VR APG Rheintal;2;VR APG Rheintal;418;2;1;1;38;19;19;0;20;438
1983;2827;Hersberg;1303;Bezirk Liestal;6;VR Alters- und Pflegeregion Liestal;6;VR Alters- und Pflegeregion Liestal;265;3;2;1;9;13;-4;0;-3;262
1983;2828;Lausen;1303;Bezirk Liestal;6;VR Alters- und Pflegeregion Liestal;6;VR Alters- und Pflegeregion Liestal;3599;52;18;34;373;290;83;0;117;3716
1983;2829;Liestal;1303;Bezirk Liestal;6;VR Alters- und Pflegeregion Liestal;6;VR Alters- und Pflegeregion Liestal;11473;128;83;45;1173;1220;-47;160;158;11631
1983;2830;Lupsingen;1303;Bezirk Liestal;6;VR Alters- und Pflegeregion Liestal;6;VR Alters- und Pflegeregion Liestal;861;9;3;6;58;25;33;0;39;900
1983;2831;Pratteln;1303;Bezirk Liestal;2;VR APG Rheintal;2;VR APG Rheintal;15541;206;96;110;1274;1262;12;2;124;15665
1983;2832;Ramlinsburg;1303;Bezirk Liestal;10;VR Waldenburgertal plus;8;VR Waldenburgertal plus;366;4;2;2;29;19;10;0;12;378
1983;2833;Seltisberg;1303;Bezirk Liestal;6;VR Alters- und Pflegeregion Liestal;6;VR Alters- und Pflegeregion Liestal;948;8;5;3;57;58;-1;0;2;950
1983;2834;Ziefen;1303;Bezirk Liestal;6;VR Alters- und Pflegeregion Liestal;6;VR Alters- und Pflegeregion Liestal;1005;7;5;2;31;52;-21;1;-18;987
1983;2841;Anwil;1304;Bezirk Sissach;9;VR Farnsberg plus;7;Planungsregion Oberbaselbiet;319;5;7;-2;12;12;0;0;-2;317
1983;2842;Böckten;1304;Bezirk Sissach;7;VR Oberbaselbiet;7;Planungsregion Oberbaselbiet;536;4;5;-1;44;51;-7;0;-8;528
1983;2843;Buckten;1304;Bezirk Sissach;8;VR Oberes Homburgertal;7;Planungsregion Oberbaselbiet;627;6;6;0;51;70;-19;0;-19;608
1983;2844;Buus;1304;Bezirk Sissach;9;VR Farnsberg plus;7;Planungsregion Oberbaselbiet;732;6;5;1;46;34;12;0;13;745
1983;2845;Diepflingen;1304;Bezirk Sissach;7;VR Oberbaselbiet;7;Planungsregion Oberbaselbiet;428;4;2;2;32;29;3;0;5;433
1983;2846;Gelterkinden;1304;Bezirk Sissach;7;VR Oberbaselbiet;7;Planungsregion Oberbaselbiet;5064;62;33;29;374;362;12;0;41;5105
1983;2847;Häfelfingen;1304;Bezirk Sissach;8;VR Oberes Homburgertal;7;Planungsregion Oberbaselbiet;215;0;1;-1;19;11;8;0;7;222
1983;2848;Hemmiken;1304;Bezirk Sissach;9;VR Farnsberg plus;7;Planungsregion Oberbaselbiet;255;0;1;-1;10;12;-2;2;-1;254
1983;2849;Itingen;1304;Bezirk Sissach;7;VR Oberbaselbiet;7;Planungsregion Oberbaselbiet;1167;13;15;-2;112;96;16;0;14;1181
1983;2850;Känerkinden;1304;Bezirk Sissach;8;VR Oberes Homburgertal;7;Planungsregion Oberbaselbiet;331;2;1;1;37;17;20;0;21;352
1983;2851;Kilchberg (BL);1304;Bezirk Sissach;9;VR Farnsberg plus;7;Planungsregion Oberbaselbiet;113;3;2;1;5;5;0;0;1;114
1983;2852;Läufelfingen;1304;Bezirk Sissach;8;VR Oberes Homburgertal;7;Planungsregion Oberbaselbiet;1233;17;11;6;95;142;-47;0;-41;1192
1983;2853;Maisprach;1304;Bezirk Sissach;9;VR Farnsberg plus;7;Planungsregion Oberbaselbiet;578;5;5;0;35;31;4;0;4;582
1983;2854;Nusshof;1304;Bezirk Sissach;7;VR Oberbaselbiet;7;Planungsregion Oberbaselbiet;154;0;3;-3;13;16;-3;0;-6;148
1983;2855;Oltingen;1304;Bezirk Sissach;9;VR Farnsberg plus;7;Planungsregion Oberbaselbiet;334;4;5;-1;22;9;13;0;12;346
1983;2856;Ormalingen;1304;Bezirk Sissach;7;VR Oberbaselbiet;7;Planungsregion Oberbaselbiet;1352;16;13;3;90;76;14;0;17;1369
1983;2857;Rickenbach (BL);1304;Bezirk Sissach;9;VR Farnsberg plus;7;Planungsregion Oberbaselbiet;369;5;1;4;32;18;14;0;18;387
1983;2858;Rothenfluh;1304;Bezirk Sissach;9;VR Farnsberg plus;7;Planungsregion Oberbaselbiet;640;8;6;2;26;28;-2;0;0;640
1983;2859;Rümlingen;1304;Bezirk Sissach;8;VR Oberes Homburgertal;7;Planungsregion Oberbaselbiet;334;3;2;1;27;29;-2;-10;-11;323
1983;2860;Rünenberg;1304;Bezirk Sissach;9;VR Farnsberg plus;7;Planungsregion Oberbaselbiet;518;3;5;-2;30;21;9;0;7;525
1983;2861;Sissach;1304;Bezirk Sissach;7;VR Oberbaselbiet;7;Planungsregion Oberbaselbiet;4646;47;51;-4;392;380;12;0;8;4654
1983;2862;Tecknau;1304;Bezirk Sissach;7;VR Oberbaselbiet;7;Planungsregion Oberbaselbiet;720;11;8;3;94;109;-15;0;-12;708
1983;2863;Tenniken;1304;Bezirk Sissach;7;VR Oberbaselbiet;7;Planungsregion Oberbaselbiet;712;13;6;7;55;60;-5;0;2;714
1983;2864;Thürnen;1304;Bezirk Sissach;7;VR Oberbaselbiet;7;Planungsregion Oberbaselbiet;968;12;5;7;52;78;-26;0;-19;949
1983;2865;Wenslingen;1304;Bezirk Sissach;7;VR Oberbaselbiet;7;Planungsregion Oberbaselbiet;541;5;2;3;32;34;-2;0;1;542
1983;2866;Wintersingen;1304;Bezirk Sissach;9;VR Farnsberg plus;7;Planungsregion Oberbaselbiet;453;4;10;-6;31;16;15;0;9;462
1983;2867;Wittinsburg;1304;Bezirk Sissach;7;VR Oberbaselbiet;7;Planungsregion Oberbaselbiet;238;0;2;-2;10;12;-2;0;-4;234
1983;2868;Zeglingen;1304;Bezirk Sissach;9;VR Farnsberg plus;7;Planungsregion Oberbaselbiet;451;6;2;4;23;23;0;0;4;455
1983;2869;Zunzgen;1304;Bezirk Sissach;7;VR Oberbaselbiet;7;Planungsregion Oberbaselbiet;1570;16;6;10;182;121;61;2;73;1643
1983;2881;Arboldswil;1305;Bezirk Waldenburg;10;VR Waldenburgertal plus;8;VR Waldenburgertal plus;406;3;5;-2;17;20;-3;0;-5;401
1983;2882;Bennwil;1305;Bezirk Waldenburg;10;VR Waldenburgertal plus;8;VR Waldenburgertal plus;453;6;7;-1;47;16;31;0;30;483
1983;2883;Bretzwil;1305;Bezirk Waldenburg;10;VR Waldenburgertal plus;8;VR Waldenburgertal plus;681;6;7;-1;28;29;-1;2;0;681
1983;2884;Diegten;1305;Bezirk Waldenburg;7;VR Oberbaselbiet;7;Planungsregion Oberbaselbiet;926;11;5;6;75;63;12;0;18;944
1983;2885;Eptingen;1305;Bezirk Waldenburg;7;VR Oberbaselbiet;7;Planungsregion Oberbaselbiet;528;8;3;5;46;47;-1;0;4;532
1983;2886;Hölstein;1305;Bezirk Waldenburg;10;VR Waldenburgertal plus;8;VR Waldenburgertal plus;1589;15;11;4;84;108;-24;0;-20;1569
1983;2887;Lampenberg;1305;Bezirk Waldenburg;10;VR Waldenburgertal plus;8;VR Waldenburgertal plus;424;4;2;2;19;12;7;0;9;433
1983;2888;Langenbruck;1305;Bezirk Waldenburg;10;VR Waldenburgertal plus;8;VR Waldenburgertal plus;830;13;4;9;89;87;2;0;11;841
1983;2889;Lauwil;1305;Bezirk Waldenburg;10;VR Waldenburgertal plus;8;VR Waldenburgertal plus;316;1;4;-3;10;11;-1;0;-4;312
1983;2890;Liedertswil;1305;Bezirk Waldenburg;10;VR Waldenburgertal plus;8;VR Waldenburgertal plus;147;2;2;0;15;15;0;0;0;147
1983;2891;Niederdorf;1305;Bezirk Waldenburg;10;VR Waldenburgertal plus;8;VR Waldenburgertal plus;1510;16;12;4;115;135;-20;0;-16;1494
1983;2892;Oberdorf (BL);1305;Bezirk Waldenburg;10;VR Waldenburgertal plus;8;VR Waldenburgertal plus;1950;17;19;-2;131;136;-5;0;-7;1943
1983;2893;Reigoldswil;1305;Bezirk Waldenburg;10;VR Waldenburgertal plus;8;VR Waldenburgertal plus;1370;13;14;-1;68;92;-24;0;-25;1345
1983;2894;Titterten;1305;Bezirk Waldenburg;10;VR Waldenburgertal plus;8;VR Waldenburgertal plus;343;4;8;-4;10;11;-1;0;-5;338
1983;2895;Waldenburg;1305;Bezirk Waldenburg;10;VR Waldenburgertal plus;8;VR Waldenburgertal plus;1222;19;10;9;100;110;-10;0;-1;1221
1984;2761;Aesch (BL);1301;Bezirk Arlesheim;3;VR Alter Birsstadt;3;VR Alter Birsstadt;8463;109;46;63;911;703;208;1;272;8735
1984;2762;Allschwil;1301;Bezirk Arlesheim;1;VR Alter und Gesundheit ABS;1;VR Alter und Gesundheit ABS;18334;202;131;71;1447;1433;14;0;85;18419
1984;2763;Arlesheim;1301;Bezirk Arlesheim;3;VR Alter Birsstadt;3;VR Alter Birsstadt;8522;66;67;-1;715;712;3;0;2;8524
1984;2764;Biel-Benken;1301;Bezirk Arlesheim;4;VR BPA Leimental;4;VR BPA Leimental;2062;20;16;4;126;119;7;0;11;2073
1984;2765;Binningen;1301;Bezirk Arlesheim;1;VR Alter und Gesundheit ABS;1;VR Alter und Gesundheit ABS;14035;113;112;1;1177;1320;-143;0;-142;13893
1984;2766;Birsfelden;1301;Bezirk Arlesheim;2;VR APG Rheintal;2;VR APG Rheintal;12371;132;94;38;825;997;-172;0;-134;12237
1984;2767;Bottmingen;1301;Bezirk Arlesheim;4;VR BPA Leimental;4;VR BPA Leimental;5197;49;22;27;516;485;31;3;61;5258
1984;2768;Ettingen;1301;Bezirk Arlesheim;4;VR BPA Leimental;4;VR BPA Leimental;4383;71;16;55;412;348;64;0;119;4502
1984;2769;Münchenstein;1301;Bezirk Arlesheim;3;VR Alter Birsstadt;3;VR Alter Birsstadt;11156;103;98;5;931;893;38;0;43;11199
1984;2770;Muttenz;1301;Bezirk Arlesheim;2;VR APG Rheintal;2;VR APG Rheintal;17152;174;134;40;1249;1222;27;0;67;17219
1984;2771;Oberwil (BL);1301;Bezirk Arlesheim;4;VR BPA Leimental;4;VR BPA Leimental;7962;99;40;59;714;708;6;0;65;8027
1984;2772;Pfeffingen;1301;Bezirk Arlesheim;3;VR Alter Birsstadt;3;VR Alter Birsstadt;1399;16;6;10;158;107;51;0;61;1460
1984;2773;Reinach (BL);1301;Bezirk Arlesheim;3;VR Alter Birsstadt;3;VR Alter Birsstadt;18019;205;94;111;1373;1348;25;0;136;18155
1984;2774;Schönenbuch;1301;Bezirk Arlesheim;1;VR Alter und Gesundheit ABS;1;VR Alter und Gesundheit ABS;884;5;1;4;74;60;14;0;18;902
1984;2775;Therwil;1301;Bezirk Arlesheim;4;VR BPA Leimental;4;VR BPA Leimental;7530;89;36;53;517;566;-49;0;4;7534
1984;2821;Arisdorf;1303;Bezirk Liestal;6;VR Alters- und Pflegeregion Liestal;6;VR Alters- und Pflegeregion Liestal;1053;11;11;0;78;67;11;0;11;1064
1984;2822;Augst;1303;Bezirk Liestal;2;VR APG Rheintal;2;VR APG Rheintal;858;10;5;5;118;130;-12;0;-7;851
1984;2823;Bubendorf;1303;Bezirk Liestal;6;VR Alters- und Pflegeregion Liestal;6;VR Alters- und Pflegeregion Liestal;2419;28;25;3;369;205;164;0;167;2586
1984;2824;Frenkendorf;1303;Bezirk Liestal;6;VR Alters- und Pflegeregion Liestal;6;VR Alters- und Pflegeregion Liestal;5600;68;30;38;570;557;13;0;51;5651
1984;2825;Füllinsdorf;1303;Bezirk Liestal;6;VR Alters- und Pflegeregion Liestal;6;VR Alters- und Pflegeregion Liestal;4108;50;29;21;398;406;-8;0;13;4121
1984;2826;Giebenach;1303;Bezirk Liestal;2;VR APG Rheintal;2;VR APG Rheintal;438;5;3;2;34;16;18;0;20;458
1984;2827;Hersberg;1303;Bezirk Liestal;6;VR Alters- und Pflegeregion Liestal;6;VR Alters- und Pflegeregion Liestal;262;0;0;0;23;16;7;-1;6;268
1984;2828;Lausen;1303;Bezirk Liestal;6;VR Alters- und Pflegeregion Liestal;6;VR Alters- und Pflegeregion Liestal;3716;58;15;43;385;339;46;0;89;3805
1984;2829;Liestal;1303;Bezirk Liestal;6;VR Alters- und Pflegeregion Liestal;6;VR Alters- und Pflegeregion Liestal;11631;144;96;48;1111;1112;-1;0;47;11678
1984;2830;Lupsingen;1303;Bezirk Liestal;6;VR Alters- und Pflegeregion Liestal;6;VR Alters- und Pflegeregion Liestal;900;6;2;4;96;51;45;0;49;949
1984;2831;Pratteln;1303;Bezirk Liestal;2;VR APG Rheintal;2;VR APG Rheintal;15665;201;107;94;1298;1422;-124;-46;-76;15589
1984;2832;Ramlinsburg;1303;Bezirk Liestal;10;VR Waldenburgertal plus;8;VR Waldenburgertal plus;378;1;5;-4;11;20;-9;0;-13;365
1984;2833;Seltisberg;1303;Bezirk Liestal;6;VR Alters- und Pflegeregion Liestal;6;VR Alters- und Pflegeregion Liestal;950;14;3;11;35;43;-8;-11;-8;942
1984;2834;Ziefen;1303;Bezirk Liestal;6;VR Alters- und Pflegeregion Liestal;6;VR Alters- und Pflegeregion Liestal;987;14;13;1;46;37;9;0;10;997
1984;2841;Anwil;1304;Bezirk Sissach;9;VR Farnsberg plus;7;Planungsregion Oberbaselbiet;317;3;7;-4;10;9;1;0;-3;314
1984;2842;Böckten;1304;Bezirk Sissach;7;VR Oberbaselbiet;7;Planungsregion Oberbaselbiet;528;3;5;-2;54;32;22;0;20;548
1984;2843;Buckten;1304;Bezirk Sissach;8;VR Oberes Homburgertal;7;Planungsregion Oberbaselbiet;608;9;9;0;65;61;4;0;4;612
1984;2844;Buus;1304;Bezirk Sissach;9;VR Farnsberg plus;7;Planungsregion Oberbaselbiet;745;14;3;11;23;40;-17;0;-6;739
1984;2845;Diepflingen;1304;Bezirk Sissach;7;VR Oberbaselbiet;7;Planungsregion Oberbaselbiet;433;2;1;1;41;44;-3;0;-2;431
1984;2846;Gelterkinden;1304;Bezirk Sissach;7;VR Oberbaselbiet;7;Planungsregion Oberbaselbiet;5105;51;35;16;409;363;46;0;62;5167
1984;2847;Häfelfingen;1304;Bezirk Sissach;8;VR Oberes Homburgertal;7;Planungsregion Oberbaselbiet;222;2;4;-2;18;16;2;0;0;222
1984;2848;Hemmiken;1304;Bezirk Sissach;9;VR Farnsberg plus;7;Planungsregion Oberbaselbiet;254;2;2;0;15;12;3;0;3;257
1984;2849;Itingen;1304;Bezirk Sissach;7;VR Oberbaselbiet;7;Planungsregion Oberbaselbiet;1181;13;6;7;160;88;72;0;79;1260
1984;2850;Känerkinden;1304;Bezirk Sissach;8;VR Oberes Homburgertal;7;Planungsregion Oberbaselbiet;352;4;1;3;32;26;6;0;9;361
1984;2851;Kilchberg (BL);1304;Bezirk Sissach;9;VR Farnsberg plus;7;Planungsregion Oberbaselbiet;114;3;1;2;7;12;-5;0;-3;111
1984;2852;Läufelfingen;1304;Bezirk Sissach;8;VR Oberes Homburgertal;7;Planungsregion Oberbaselbiet;1192;18;9;9;119;89;30;-64;-25;1167
1984;2853;Maisprach;1304;Bezirk Sissach;9;VR Farnsberg plus;7;Planungsregion Oberbaselbiet;582;8;4;4;37;37;0;0;4;586
1984;2854;Nusshof;1304;Bezirk Sissach;7;VR Oberbaselbiet;7;Planungsregion Oberbaselbiet;148;2;2;0;8;12;-4;0;-4;144
1984;2855;Oltingen;1304;Bezirk Sissach;9;VR Farnsberg plus;7;Planungsregion Oberbaselbiet;346;5;6;-1;12;22;-10;0;-11;335
1984;2856;Ormalingen;1304;Bezirk Sissach;7;VR Oberbaselbiet;7;Planungsregion Oberbaselbiet;1369;15;8;7;88;91;-3;0;4;1373
1984;2857;Rickenbach (BL);1304;Bezirk Sissach;9;VR Farnsberg plus;7;Planungsregion Oberbaselbiet;387;5;0;5;21;12;9;0;14;401
1984;2858;Rothenfluh;1304;Bezirk Sissach;9;VR Farnsberg plus;7;Planungsregion Oberbaselbiet;640;8;3;5;19;38;-19;0;-14;626
1984;2859;Rümlingen;1304;Bezirk Sissach;8;VR Oberes Homburgertal;7;Planungsregion Oberbaselbiet;323;3;3;0;12;25;-13;0;-13;310
1984;2860;Rünenberg;1304;Bezirk Sissach;9;VR Farnsberg plus;7;Planungsregion Oberbaselbiet;525;5;2;3;53;23;30;0;33;558
1984;2861;Sissach;1304;Bezirk Sissach;7;VR Oberbaselbiet;7;Planungsregion Oberbaselbiet;4654;45;33;12;473;364;109;0;121;4775
1984;2862;Tecknau;1304;Bezirk Sissach;7;VR Oberbaselbiet;7;Planungsregion Oberbaselbiet;708;7;5;2;85;87;-2;0;0;708
1984;2863;Tenniken;1304;Bezirk Sissach;7;VR Oberbaselbiet;7;Planungsregion Oberbaselbiet;714;18;6;12;63;51;12;0;24;738
1984;2864;Thürnen;1304;Bezirk Sissach;7;VR Oberbaselbiet;7;Planungsregion Oberbaselbiet;949;11;2;9;78;107;-29;0;-20;929
1984;2865;Wenslingen;1304;Bezirk Sissach;7;VR Oberbaselbiet;7;Planungsregion Oberbaselbiet;542;9;2;7;43;19;24;0;31;573
1984;2866;Wintersingen;1304;Bezirk Sissach;9;VR Farnsberg plus;7;Planungsregion Oberbaselbiet;462;2;3;-1;19;19;0;0;-1;461
1984;2867;Wittinsburg;1304;Bezirk Sissach;7;VR Oberbaselbiet;7;Planungsregion Oberbaselbiet;234;2;5;-3;11;11;0;0;-3;231
1984;2868;Zeglingen;1304;Bezirk Sissach;9;VR Farnsberg plus;7;Planungsregion Oberbaselbiet;455;6;3;3;21;27;-6;-1;-4;451
1984;2869;Zunzgen;1304;Bezirk Sissach;7;VR Oberbaselbiet;7;Planungsregion Oberbaselbiet;1643;21;12;9;194;119;75;0;84;1727
1984;2881;Arboldswil;1305;Bezirk Waldenburg;10;VR Waldenburgertal plus;8;VR Waldenburgertal plus;401;2;4;-2;18;27;-9;0;-11;390
1984;2882;Bennwil;1305;Bezirk Waldenburg;10;VR Waldenburgertal plus;8;VR Waldenburgertal plus;483;5;5;0;22;23;-1;0;-1;482
1984;2883;Bretzwil;1305;Bezirk Waldenburg;10;VR Waldenburgertal plus;8;VR Waldenburgertal plus;681;13;8;5;47;47;0;0;5;686
1984;2884;Diegten;1305;Bezirk Waldenburg;7;VR Oberbaselbiet;7;Planungsregion Oberbaselbiet;944;19;5;14;70;54;16;0;30;974
1984;2885;Eptingen;1305;Bezirk Waldenburg;7;VR Oberbaselbiet;7;Planungsregion Oberbaselbiet;532;7;11;-4;44;32;12;0;8;540
1984;2886;Hölstein;1305;Bezirk Waldenburg;10;VR Waldenburgertal plus;8;VR Waldenburgertal plus;1569;22;12;10;143;117;26;0;36;1605
1984;2887;Lampenberg;1305;Bezirk Waldenburg;10;VR Waldenburgertal plus;8;VR Waldenburgertal plus;433;3;5;-2;16;16;0;0;-2;431
1984;2888;Langenbruck;1305;Bezirk Waldenburg;10;VR Waldenburgertal plus;8;VR Waldenburgertal plus;841;9;10;-1;79;98;-19;0;-20;821
1984;2889;Lauwil;1305;Bezirk Waldenburg;10;VR Waldenburgertal plus;8;VR Waldenburgertal plus;312;1;2;-1;8;20;-12;0;-13;299
1984;2890;Liedertswil;1305;Bezirk Waldenburg;10;VR Waldenburgertal plus;8;VR Waldenburgertal plus;147;2;1;1;5;11;-6;0;-5;142
1984;2891;Niederdorf;1305;Bezirk Waldenburg;10;VR Waldenburgertal plus;8;VR Waldenburgertal plus;1494;18;9;9;116;119;-3;0;6;1500
1984;2892;Oberdorf (BL);1305;Bezirk Waldenburg;10;VR Waldenburgertal plus;8;VR Waldenburgertal plus;1943;19;21;-2;129;127;2;0;0;1943
1984;2893;Reigoldswil;1305;Bezirk Waldenburg;10;VR Waldenburgertal plus;8;VR Waldenburgertal plus;1345;14;11;3;83;90;-7;0;-4;1341
1984;2894;Titterten;1305;Bezirk Waldenburg;10;VR Waldenburgertal plus;8;VR Waldenburgertal plus;338;4;4;0;15;13;2;0;2;340
1984;2895;Waldenburg;1305;Bezirk Waldenburg;10;VR Waldenburgertal plus;8;VR Waldenburgertal plus;1221;17;15;2;84;93;-9;0;-7;1214
1985;2761;Aesch (BL);1301;Bezirk Arlesheim;3;VR Alter Birsstadt;3;VR Alter Birsstadt;8735;117;74;43;815;651;164;0;207;8942
1985;2762;Allschwil;1301;Bezirk Arlesheim;1;VR Alter und Gesundheit ABS;1;VR Alter und Gesundheit ABS;18419;187;133;54;1288;1266;22;0;76;18495
1985;2763;Arlesheim;1301;Bezirk Arlesheim;3;VR Alter Birsstadt;3;VR Alter Birsstadt;8524;69;82;-13;819;763;56;-1;42;8566
1985;2764;Biel-Benken;1301;Bezirk Arlesheim;4;VR BPA Leimental;4;VR BPA Leimental;2073;17;12;5;194;130;64;0;69;2142
1985;2765;Binningen;1301;Bezirk Arlesheim;1;VR Alter und Gesundheit ABS;1;VR Alter und Gesundheit ABS;13893;131;121;10;1322;1224;98;0;108;14001
1985;2766;Birsfelden;1301;Bezirk Arlesheim;2;VR APG Rheintal;2;VR APG Rheintal;12237;119;86;33;837;952;-115;0;-82;12155
1985;2767;Bottmingen;1301;Bezirk Arlesheim;4;VR BPA Leimental;4;VR BPA Leimental;5258;47;22;25;518;435;83;0;108;5366
1985;2768;Ettingen;1301;Bezirk Arlesheim;4;VR BPA Leimental;4;VR BPA Leimental;4502;64;14;50;408;338;70;0;120;4622
1985;2769;Münchenstein;1301;Bezirk Arlesheim;3;VR Alter Birsstadt;3;VR Alter Birsstadt;11199;124;73;51;1184;880;304;0;355;11554
1985;2770;Muttenz;1301;Bezirk Arlesheim;2;VR APG Rheintal;2;VR APG Rheintal;17219;176;131;45;1099;1151;-52;0;-7;17212
1985;2771;Oberwil (BL);1301;Bezirk Arlesheim;4;VR BPA Leimental;4;VR BPA Leimental;8027;81;54;27;774;669;105;0;132;8159
1985;2772;Pfeffingen;1301;Bezirk Arlesheim;3;VR Alter Birsstadt;3;VR Alter Birsstadt;1460;14;5;9;118;108;10;0;19;1479
1985;2773;Reinach (BL);1301;Bezirk Arlesheim;3;VR Alter Birsstadt;3;VR Alter Birsstadt;18155;178;103;75;1291;1372;-81;0;-6;18149
1985;2774;Schönenbuch;1301;Bezirk Arlesheim;1;VR Alter und Gesundheit ABS;1;VR Alter und Gesundheit ABS;902;9;5;4;81;50;31;0;35;937
1985;2775;Therwil;1301;Bezirk Arlesheim;4;VR BPA Leimental;4;VR BPA Leimental;7534;89;35;54;539;572;-33;0;21;7555
1985;2821;Arisdorf;1303;Bezirk Liestal;6;VR Alters- und Pflegeregion Liestal;6;VR Alters- und Pflegeregion Liestal;1064;2;6;-4;66;49;17;0;13;1077
1985;2822;Augst;1303;Bezirk Liestal;2;VR APG Rheintal;2;VR APG Rheintal;851;7;7;0;108;124;-16;0;-16;835
1985;2823;Bubendorf;1303;Bezirk Liestal;6;VR Alters- und Pflegeregion Liestal;6;VR Alters- und Pflegeregion Liestal;2586;32;17;15;311;181;130;0;145;2731
1985;2824;Frenkendorf;1303;Bezirk Liestal;6;VR Alters- und Pflegeregion Liestal;6;VR Alters- und Pflegeregion Liestal;5651;74;28;46;471;552;-81;0;-35;5616
1985;2825;Füllinsdorf;1303;Bezirk Liestal;6;VR Alters- und Pflegeregion Liestal;6;VR Alters- und Pflegeregion Liestal;4121;45;14;31;330;360;-30;0;1;4122
1985;2826;Giebenach;1303;Bezirk Liestal;2;VR APG Rheintal;2;VR APG Rheintal;458;7;4;3;36;31;5;0;8;466
1985;2827;Hersberg;1303;Bezirk Liestal;6;VR Alters- und Pflegeregion Liestal;6;VR Alters- und Pflegeregion Liestal;268;2;2;0;14;14;0;0;0;268
1985;2828;Lausen;1303;Bezirk Liestal;6;VR Alters- und Pflegeregion Liestal;6;VR Alters- und Pflegeregion Liestal;3805;59;40;19;290;316;-26;0;-7;3798
1985;2829;Liestal;1303;Bezirk Liestal;6;VR Alters- und Pflegeregion Liestal;6;VR Alters- und Pflegeregion Liestal;11678;125;99;26;1208;1185;23;0;49;11727
1985;2830;Lupsingen;1303;Bezirk Liestal;6;VR Alters- und Pflegeregion Liestal;6;VR Alters- und Pflegeregion Liestal;949;11;4;7;55;46;9;0;16;965
1985;2831;Pratteln;1303;Bezirk Liestal;2;VR APG Rheintal;2;VR APG Rheintal;15589;185;102;83;1185;1364;-179;0;-96;15493
1985;2832;Ramlinsburg;1303;Bezirk Liestal;10;VR Waldenburgertal plus;8;VR Waldenburgertal plus;365;7;4;3;36;23;13;0;16;381
1985;2833;Seltisberg;1303;Bezirk Liestal;6;VR Alters- und Pflegeregion Liestal;6;VR Alters- und Pflegeregion Liestal;942;11;6;5;65;61;4;44;53;995
1985;2834;Ziefen;1303;Bezirk Liestal;6;VR Alters- und Pflegeregion Liestal;6;VR Alters- und Pflegeregion Liestal;997;9;7;2;57;63;-6;0;-4;993
1985;2841;Anwil;1304;Bezirk Sissach;9;VR Farnsberg plus;7;Planungsregion Oberbaselbiet;314;3;3;0;28;11;17;0;17;331
1985;2842;Böckten;1304;Bezirk Sissach;7;VR Oberbaselbiet;7;Planungsregion Oberbaselbiet;548;10;4;6;43;61;-18;0;-12;536
1985;2843;Buckten;1304;Bezirk Sissach;8;VR Oberes Homburgertal;7;Planungsregion Oberbaselbiet;612;8;6;2;76;60;16;0;18;630
1985;2844;Buus;1304;Bezirk Sissach;9;VR Farnsberg plus;7;Planungsregion Oberbaselbiet;739;12;5;7;33;29;4;0;11;750
1985;2845;Diepflingen;1304;Bezirk Sissach;7;VR Oberbaselbiet;7;Planungsregion Oberbaselbiet;431;7;2;5;39;50;-11;0;-6;425
1985;2846;Gelterkinden;1304;Bezirk Sissach;7;VR Oberbaselbiet;7;Planungsregion Oberbaselbiet;5167;71;30;41;365;387;-22;0;19;5186
1985;2847;Häfelfingen;1304;Bezirk Sissach;8;VR Oberes Homburgertal;7;Planungsregion Oberbaselbiet;222;1;1;0;13;13;0;0;0;222
1985;2848;Hemmiken;1304;Bezirk Sissach;9;VR Farnsberg plus;7;Planungsregion Oberbaselbiet;257;2;2;0;9;21;-12;0;-12;245
1985;2849;Itingen;1304;Bezirk Sissach;7;VR Oberbaselbiet;7;Planungsregion Oberbaselbiet;1260;16;8;8;177;96;81;0;89;1349
1985;2850;Känerkinden;1304;Bezirk Sissach;8;VR Oberes Homburgertal;7;Planungsregion Oberbaselbiet;361;3;0;3;25;11;14;0;17;378
1985;2851;Kilchberg (BL);1304;Bezirk Sissach;9;VR Farnsberg plus;7;Planungsregion Oberbaselbiet;111;0;0;0;6;4;2;0;2;113
1985;2852;Läufelfingen;1304;Bezirk Sissach;8;VR Oberes Homburgertal;7;Planungsregion Oberbaselbiet;1167;19;10;9;79;79;0;0;9;1176
1985;2853;Maisprach;1304;Bezirk Sissach;9;VR Farnsberg plus;7;Planungsregion Oberbaselbiet;586;13;5;8;31;27;4;0;12;598
1985;2854;Nusshof;1304;Bezirk Sissach;7;VR Oberbaselbiet;7;Planungsregion Oberbaselbiet;144;4;3;1;11;1;10;0;11;155
1985;2855;Oltingen;1304;Bezirk Sissach;9;VR Farnsberg plus;7;Planungsregion Oberbaselbiet;335;5;3;2;26;22;4;0;6;341
1985;2856;Ormalingen;1304;Bezirk Sissach;7;VR Oberbaselbiet;7;Planungsregion Oberbaselbiet;1373;25;10;15;98;95;3;0;18;1391
1985;2857;Rickenbach (BL);1304;Bezirk Sissach;9;VR Farnsberg plus;7;Planungsregion Oberbaselbiet;401;4;1;3;21;13;8;0;11;412
1985;2858;Rothenfluh;1304;Bezirk Sissach;9;VR Farnsberg plus;7;Planungsregion Oberbaselbiet;626;4;4;0;20;24;-4;0;-4;622
1985;2859;Rümlingen;1304;Bezirk Sissach;8;VR Oberes Homburgertal;7;Planungsregion Oberbaselbiet;310;3;1;2;40;41;-1;0;1;311
1985;2860;Rünenberg;1304;Bezirk Sissach;9;VR Farnsberg plus;7;Planungsregion Oberbaselbiet;558;5;5;0;29;32;-3;0;-3;555
1985;2861;Sissach;1304;Bezirk Sissach;7;VR Oberbaselbiet;7;Planungsregion Oberbaselbiet;4775;63;50;13;454;419;35;0;48;4823
1985;2862;Tecknau;1304;Bezirk Sissach;7;VR Oberbaselbiet;7;Planungsregion Oberbaselbiet;708;15;8;7;83;102;-19;0;-12;696
1985;2863;Tenniken;1304;Bezirk Sissach;7;VR Oberbaselbiet;7;Planungsregion Oberbaselbiet;738;6;7;-1;47;51;-4;0;-5;733
1985;2864;Thürnen;1304;Bezirk Sissach;7;VR Oberbaselbiet;7;Planungsregion Oberbaselbiet;929;15;3;12;94;97;-3;0;9;938
1985;2865;Wenslingen;1304;Bezirk Sissach;7;VR Oberbaselbiet;7;Planungsregion Oberbaselbiet;573;8;5;3;19;26;-7;0;-4;569
1985;2866;Wintersingen;1304;Bezirk Sissach;9;VR Farnsberg plus;7;Planungsregion Oberbaselbiet;461;4;1;3;40;22;18;0;21;482
1985;2867;Wittinsburg;1304;Bezirk Sissach;7;VR Oberbaselbiet;7;Planungsregion Oberbaselbiet;231;1;1;0;18;9;9;0;9;240
1985;2868;Zeglingen;1304;Bezirk Sissach;9;VR Farnsberg plus;7;Planungsregion Oberbaselbiet;451;5;9;-4;10;22;-12;-1;-17;434
1985;2869;Zunzgen;1304;Bezirk Sissach;7;VR Oberbaselbiet;7;Planungsregion Oberbaselbiet;1727;22;11;11;232;140;92;-1;102;1829
1985;2881;Arboldswil;1305;Bezirk Waldenburg;10;VR Waldenburgertal plus;8;VR Waldenburgertal plus;390;7;6;1;23;14;9;0;10;400
1985;2882;Bennwil;1305;Bezirk Waldenburg;10;VR Waldenburgertal plus;8;VR Waldenburgertal plus;482;8;4;4;25;23;2;0;6;488
1985;2883;Bretzwil;1305;Bezirk Waldenburg;10;VR Waldenburgertal plus;8;VR Waldenburgertal plus;686;9;8;1;29;38;-9;0;-8;678
1985;2884;Diegten;1305;Bezirk Waldenburg;7;VR Oberbaselbiet;7;Planungsregion Oberbaselbiet;974;14;8;6;92;94;-2;0;4;978
1985;2885;Eptingen;1305;Bezirk Waldenburg;7;VR Oberbaselbiet;7;Planungsregion Oberbaselbiet;540;9;7;2;30;34;-4;0;-2;538
1985;2886;Hölstein;1305;Bezirk Waldenburg;10;VR Waldenburgertal plus;8;VR Waldenburgertal plus;1605;25;9;16;135;115;20;0;36;1641
1985;2887;Lampenberg;1305;Bezirk Waldenburg;10;VR Waldenburgertal plus;8;VR Waldenburgertal plus;431;8;3;5;23;19;4;0;9;440
1985;2888;Langenbruck;1305;Bezirk Waldenburg;10;VR Waldenburgertal plus;8;VR Waldenburgertal plus;821;5;9;-4;87;92;-5;0;-9;812
1985;2889;Lauwil;1305;Bezirk Waldenburg;10;VR Waldenburgertal plus;8;VR Waldenburgertal plus;299;4;9;-5;13;16;-3;0;-8;291
1985;2890;Liedertswil;1305;Bezirk Waldenburg;10;VR Waldenburgertal plus;8;VR Waldenburgertal plus;142;3;2;1;11;10;1;0;2;144
1985;2891;Niederdorf;1305;Bezirk Waldenburg;10;VR Waldenburgertal plus;8;VR Waldenburgertal plus;1500;26;13;13;65;70;-5;0;8;1508
1985;2892;Oberdorf (BL);1305;Bezirk Waldenburg;10;VR Waldenburgertal plus;8;VR Waldenburgertal plus;1943;14;20;-6;123;97;26;0;20;1963
1985;2893;Reigoldswil;1305;Bezirk Waldenburg;10;VR Waldenburgertal plus;8;VR Waldenburgertal plus;1341;17;12;5;81;88;-7;0;-2;1339
1985;2894;Titterten;1305;Bezirk Waldenburg;10;VR Waldenburgertal plus;8;VR Waldenburgertal plus;340;5;5;0;16;9;7;0;7;347
1985;2895;Waldenburg;1305;Bezirk Waldenburg;10;VR Waldenburgertal plus;8;VR Waldenburgertal plus;1214;12;8;4;74;82;-8;0;-4;1210
1986;2761;Aesch (BL);1301;Bezirk Arlesheim;3;VR Alter Birsstadt;3;VR Alter Birsstadt;8942;116;47;69;885;812;73;0;142;9084
1986;2762;Allschwil;1301;Bezirk Arlesheim;1;VR Alter und Gesundheit ABS;1;VR Alter und Gesundheit ABS;18495;175;161;14;1418;1370;48;0;62;18557
1986;2763;Arlesheim;1301;Bezirk Arlesheim;3;VR Alter Birsstadt;3;VR Alter Birsstadt;8566;76;86;-10;743;824;-81;0;-91;8475
1986;2764;Biel-Benken;1301;Bezirk Arlesheim;4;VR BPA Leimental;4;VR BPA Leimental;2142;16;13;3;198;135;63;0;66;2208
1986;2765;Binningen;1301;Bezirk Arlesheim;1;VR Alter und Gesundheit ABS;1;VR Alter und Gesundheit ABS;14001;129;124;5;1320;1394;-74;0;-69;13932
1986;2766;Birsfelden;1301;Bezirk Arlesheim;2;VR APG Rheintal;2;VR APG Rheintal;12155;121;103;18;910;985;-75;0;-57;12098
1986;2767;Bottmingen;1301;Bezirk Arlesheim;4;VR BPA Leimental;4;VR BPA Leimental;5366;54;33;21;518;543;-25;0;-4;5362
1986;2768;Ettingen;1301;Bezirk Arlesheim;4;VR BPA Leimental;4;VR BPA Leimental;4622;62;22;40;360;424;-64;0;-24;4598
1986;2769;Münchenstein;1301;Bezirk Arlesheim;3;VR Alter Birsstadt;3;VR Alter Birsstadt;11554;122;103;19;1030;976;54;0;73;11627
1986;2770;Muttenz;1301;Bezirk Arlesheim;2;VR APG Rheintal;2;VR APG Rheintal;17212;167;120;47;1192;1134;58;0;105;17317
1986;2771;Oberwil (BL);1301;Bezirk Arlesheim;4;VR BPA Leimental;4;VR BPA Leimental;8159;78;52;26;893;735;158;0;184;8343
1986;2772;Pfeffingen;1301;Bezirk Arlesheim;3;VR Alter Birsstadt;3;VR Alter Birsstadt;1479;17;7;10;156;75;81;0;91;1570
1986;2773;Reinach (BL);1301;Bezirk Arlesheim;3;VR Alter Birsstadt;3;VR Alter Birsstadt;18149;172;96;76;1026;1362;-336;0;-260;17889
1986;2774;Schönenbuch;1301;Bezirk Arlesheim;1;VR Alter und Gesundheit ABS;1;VR Alter und Gesundheit ABS;937;8;3;5;99;78;21;0;26;963
1986;2775;Therwil;1301;Bezirk Arlesheim;4;VR BPA Leimental;4;VR BPA Leimental;7555;97;29;68;502;563;-61;0;7;7562
1986;2821;Arisdorf;1303;Bezirk Liestal;6;VR Alters- und Pflegeregion Liestal;6;VR Alters- und Pflegeregion Liestal;1077;10;3;7;73;67;6;0;13;1090
1986;2822;Augst;1303;Bezirk Liestal;2;VR APG Rheintal;2;VR APG Rheintal;835;6;7;-1;117;115;2;0;1;836
1986;2823;Bubendorf;1303;Bezirk Liestal;6;VR Alters- und Pflegeregion Liestal;6;VR Alters- und Pflegeregion Liestal;2731;33;16;17;321;232;89;0;106;2837
1986;2824;Frenkendorf;1303;Bezirk Liestal;6;VR Alters- und Pflegeregion Liestal;6;VR Alters- und Pflegeregion Liestal;5616;67;39;28;528;550;-22;0;6;5622
1986;2825;Füllinsdorf;1303;Bezirk Liestal;6;VR Alters- und Pflegeregion Liestal;6;VR Alters- und Pflegeregion Liestal;4122;43;11;32;295;307;-12;1;21;4143
1986;2826;Giebenach;1303;Bezirk Liestal;2;VR APG Rheintal;2;VR APG Rheintal;466;4;2;2;58;26;32;0;34;500
1986;2827;Hersberg;1303;Bezirk Liestal;6;VR Alters- und Pflegeregion Liestal;6;VR Alters- und Pflegeregion Liestal;268;3;1;2;3;8;-5;0;-3;265
1986;2828;Lausen;1303;Bezirk Liestal;6;VR Alters- und Pflegeregion Liestal;6;VR Alters- und Pflegeregion Liestal;3798;52;19;33;398;333;65;0;98;3896
1986;2829;Liestal;1303;Bezirk Liestal;6;VR Alters- und Pflegeregion Liestal;6;VR Alters- und Pflegeregion Liestal;11727;161;72;89;1315;1250;65;0;154;11881
1986;2830;Lupsingen;1303;Bezirk Liestal;6;VR Alters- und Pflegeregion Liestal;6;VR Alters- und Pflegeregion Liestal;965;5;3;2;72;63;9;0;11;976
1986;2831;Pratteln;1303;Bezirk Liestal;2;VR APG Rheintal;2;VR APG Rheintal;15493;202;104;98;1214;1374;-160;1;-61;15432
1986;2832;Ramlinsburg;1303;Bezirk Liestal;10;VR Waldenburgertal plus;8;VR Waldenburgertal plus;381;2;0;2;22;16;6;0;8;389
1986;2833;Seltisberg;1303;Bezirk Liestal;6;VR Alters- und Pflegeregion Liestal;6;VR Alters- und Pflegeregion Liestal;995;12;6;6;82;78;4;0;10;1005
1986;2834;Ziefen;1303;Bezirk Liestal;6;VR Alters- und Pflegeregion Liestal;6;VR Alters- und Pflegeregion Liestal;993;10;4;6;74;67;7;0;13;1006
1986;2841;Anwil;1304;Bezirk Sissach;9;VR Farnsberg plus;7;Planungsregion Oberbaselbiet;331;7;3;4;9;7;2;0;6;337
1986;2842;Böckten;1304;Bezirk Sissach;7;VR Oberbaselbiet;7;Planungsregion Oberbaselbiet;536;5;8;-3;56;31;25;0;22;558
1986;2843;Buckten;1304;Bezirk Sissach;8;VR Oberes Homburgertal;7;Planungsregion Oberbaselbiet;630;15;5;10;63;49;14;0;24;654
1986;2844;Buus;1304;Bezirk Sissach;9;VR Farnsberg plus;7;Planungsregion Oberbaselbiet;750;9;6;3;46;40;6;0;9;759
1986;2845;Diepflingen;1304;Bezirk Sissach;7;VR Oberbaselbiet;7;Planungsregion Oberbaselbiet;425;5;4;1;23;39;-16;0;-15;410
1986;2846;Gelterkinden;1304;Bezirk Sissach;7;VR Oberbaselbiet;7;Planungsregion Oberbaselbiet;5186;46;46;0;390;391;-1;0;-1;5185
1986;2847;Häfelfingen;1304;Bezirk Sissach;8;VR Oberes Homburgertal;7;Planungsregion Oberbaselbiet;222;5;0;5;15;11;4;0;9;231
1986;2848;Hemmiken;1304;Bezirk Sissach;9;VR Farnsberg plus;7;Planungsregion Oberbaselbiet;245;1;1;0;6;15;-9;0;-9;236
1986;2849;Itingen;1304;Bezirk Sissach;7;VR Oberbaselbiet;7;Planungsregion Oberbaselbiet;1349;15;2;13;133;114;19;0;32;1381
1986;2850;Känerkinden;1304;Bezirk Sissach;8;VR Oberes Homburgertal;7;Planungsregion Oberbaselbiet;378;1;8;-7;39;29;10;0;3;381
1986;2851;Kilchberg (BL);1304;Bezirk Sissach;9;VR Farnsberg plus;7;Planungsregion Oberbaselbiet;113;1;1;0;2;1;1;0;1;114
1986;2852;Läufelfingen;1304;Bezirk Sissach;8;VR Oberes Homburgertal;7;Planungsregion Oberbaselbiet;1176;15;13;2;67;61;6;0;8;1184
1986;2853;Maisprach;1304;Bezirk Sissach;9;VR Farnsberg plus;7;Planungsregion Oberbaselbiet;598;4;5;-1;30;18;12;-2;9;607
1986;2854;Nusshof;1304;Bezirk Sissach;7;VR Oberbaselbiet;7;Planungsregion Oberbaselbiet;155;1;2;-1;20;11;9;0;8;163
1986;2855;Oltingen;1304;Bezirk Sissach;9;VR Farnsberg plus;7;Planungsregion Oberbaselbiet;341;4;6;-2;18;24;-6;0;-8;333
1986;2856;Ormalingen;1304;Bezirk Sissach;7;VR Oberbaselbiet;7;Planungsregion Oberbaselbiet;1391;24;8;16;104;102;2;0;18;1409
1986;2857;Rickenbach (BL);1304;Bezirk Sissach;9;VR Farnsberg plus;7;Planungsregion Oberbaselbiet;412;4;5;-1;19;30;-11;0;-12;400
1986;2858;Rothenfluh;1304;Bezirk Sissach;9;VR Farnsberg plus;7;Planungsregion Oberbaselbiet;622;9;14;-5;47;39;8;0;3;625
1986;2859;Rümlingen;1304;Bezirk Sissach;8;VR Oberes Homburgertal;7;Planungsregion Oberbaselbiet;311;4;3;1;33;31;2;0;3;314
1986;2860;Rünenberg;1304;Bezirk Sissach;9;VR Farnsberg plus;7;Planungsregion Oberbaselbiet;555;7;4;3;34;34;0;0;3;558
1986;2861;Sissach;1304;Bezirk Sissach;7;VR Oberbaselbiet;7;Planungsregion Oberbaselbiet;4823;67;47;20;544;457;87;0;107;4930
1986;2862;Tecknau;1304;Bezirk Sissach;7;VR Oberbaselbiet;7;Planungsregion Oberbaselbiet;696;9;5;4;69;107;-38;0;-34;662
1986;2863;Tenniken;1304;Bezirk Sissach;7;VR Oberbaselbiet;7;Planungsregion Oberbaselbiet;733;9;7;2;50;31;19;0;21;754
1986;2864;Thürnen;1304;Bezirk Sissach;7;VR Oberbaselbiet;7;Planungsregion Oberbaselbiet;938;13;3;10;103;107;-4;0;6;944
1986;2865;Wenslingen;1304;Bezirk Sissach;7;VR Oberbaselbiet;7;Planungsregion Oberbaselbiet;569;9;6;3;19;34;-15;0;-12;557
1986;2866;Wintersingen;1304;Bezirk Sissach;9;VR Farnsberg plus;7;Planungsregion Oberbaselbiet;482;6;3;3;15;25;-10;0;-7;475
1986;2867;Wittinsburg;1304;Bezirk Sissach;7;VR Oberbaselbiet;7;Planungsregion Oberbaselbiet;240;2;4;-2;20;9;11;1;10;250
1986;2868;Zeglingen;1304;Bezirk Sissach;9;VR Farnsberg plus;7;Planungsregion Oberbaselbiet;434;7;2;5;22;16;6;0;11;445
1986;2869;Zunzgen;1304;Bezirk Sissach;7;VR Oberbaselbiet;7;Planungsregion Oberbaselbiet;1829;23;16;7;289;146;143;0;150;1979
1986;2881;Arboldswil;1305;Bezirk Waldenburg;10;VR Waldenburgertal plus;8;VR Waldenburgertal plus;400;6;3;3;26;30;-4;0;-1;399
1986;2882;Bennwil;1305;Bezirk Waldenburg;10;VR Waldenburgertal plus;8;VR Waldenburgertal plus;488;4;4;0;13;33;-20;0;-20;468
1986;2883;Bretzwil;1305;Bezirk Waldenburg;10;VR Waldenburgertal plus;8;VR Waldenburgertal plus;678;9;7;2;34;41;-7;0;-5;673
1986;2884;Diegten;1305;Bezirk Waldenburg;7;VR Oberbaselbiet;7;Planungsregion Oberbaselbiet;978;16;7;9;125;81;44;0;53;1031
1986;2885;Eptingen;1305;Bezirk Waldenburg;7;VR Oberbaselbiet;7;Planungsregion Oberbaselbiet;538;8;11;-3;53;28;25;0;22;560
1986;2886;Hölstein;1305;Bezirk Waldenburg;10;VR Waldenburgertal plus;8;VR Waldenburgertal plus;1641;26;11;15;143;126;17;0;32;1673
1986;2887;Lampenberg;1305;Bezirk Waldenburg;10;VR Waldenburgertal plus;8;VR Waldenburgertal plus;440;11;2;9;17;8;9;0;18;458
1986;2888;Langenbruck;1305;Bezirk Waldenburg;10;VR Waldenburgertal plus;8;VR Waldenburgertal plus;812;15;5;10;111;76;35;0;45;857
1986;2889;Lauwil;1305;Bezirk Waldenburg;10;VR Waldenburgertal plus;8;VR Waldenburgertal plus;291;2;2;0;13;11;2;0;2;293
1986;2890;Liedertswil;1305;Bezirk Waldenburg;10;VR Waldenburgertal plus;8;VR Waldenburgertal plus;144;3;1;2;15;3;12;0;14;158
1986;2891;Niederdorf;1305;Bezirk Waldenburg;10;VR Waldenburgertal plus;8;VR Waldenburgertal plus;1508;17;7;10;94;114;-20;0;-10;1498
1986;2892;Oberdorf (BL);1305;Bezirk Waldenburg;10;VR Waldenburgertal plus;8;VR Waldenburgertal plus;1963;18;22;-4;151;143;8;0;4;1967
1986;2893;Reigoldswil;1305;Bezirk Waldenburg;10;VR Waldenburgertal plus;8;VR Waldenburgertal plus;1339;6;14;-8;79;79;0;0;-8;1331
1986;2894;Titterten;1305;Bezirk Waldenburg;10;VR Waldenburgertal plus;8;VR Waldenburgertal plus;347;3;1;2;22;25;-3;0;-1;346
1986;2895;Waldenburg;1305;Bezirk Waldenburg;10;VR Waldenburgertal plus;8;VR Waldenburgertal plus;1210;13;16;-3;97;112;-15;0;-18;1192
1987;2761;Aesch (BL);1301;Bezirk Arlesheim;3;VR Alter Birsstadt;3;VR Alter Birsstadt;9084;117;54;63;957;799;158;-1;220;9304
1987;2762;Allschwil;1301;Bezirk Arlesheim;1;VR Alter und Gesundheit ABS;1;VR Alter und Gesundheit ABS;18557;194;145;49;1548;1487;61;-2;108;18665
1987;2763;Arlesheim;1301;Bezirk Arlesheim;3;VR Alter Birsstadt;3;VR Alter Birsstadt;8475;82;87;-5;773;704;69;0;64;8539
1987;2764;Biel-Benken;1301;Bezirk Arlesheim;4;VR BPA Leimental;4;VR BPA Leimental;2208;16;10;6;157;130;27;0;33;2241
1987;2765;Binningen;1301;Bezirk Arlesheim;1;VR Alter und Gesundheit ABS;1;VR Alter und Gesundheit ABS;13932;128;117;11;1557;1326;231;0;242;14174
1987;2766;Birsfelden;1301;Bezirk Arlesheim;2;VR APG Rheintal;2;VR APG Rheintal;12098;117;88;29;897;1035;-138;-1;-110;11988
1987;2767;Bottmingen;1301;Bezirk Arlesheim;4;VR BPA Leimental;4;VR BPA Leimental;5362;46;32;14;619;487;132;0;146;5508
1987;2768;Ettingen;1301;Bezirk Arlesheim;4;VR BPA Leimental;4;VR BPA Leimental;4598;72;19;53;600;396;204;0;257;4855
1987;2769;Münchenstein;1301;Bezirk Arlesheim;3;VR Alter Birsstadt;3;VR Alter Birsstadt;11627;125;101;24;828;997;-169;0;-145;11482
1987;2770;Muttenz;1301;Bezirk Arlesheim;2;VR APG Rheintal;2;VR APG Rheintal;17317;151;115;36;1198;1253;-55;0;-19;17298
1987;2771;Oberwil (BL);1301;Bezirk Arlesheim;4;VR BPA Leimental;4;VR BPA Leimental;8343;77;60;17;1032;741;291;0;308;8651
1987;2772;Pfeffingen;1301;Bezirk Arlesheim;3;VR Alter Birsstadt;3;VR Alter Birsstadt;1570;14;4;10;141;116;25;0;35;1605
1987;2773;Reinach (BL);1301;Bezirk Arlesheim;3;VR Alter Birsstadt;3;VR Alter Birsstadt;17889;180;95;85;1469;1321;148;2;235;18124
1987;2774;Schönenbuch;1301;Bezirk Arlesheim;1;VR Alter und Gesundheit ABS;1;VR Alter und Gesundheit ABS;963;9;6;3;79;63;16;0;19;982
1987;2775;Therwil;1301;Bezirk Arlesheim;4;VR BPA Leimental;4;VR BPA Leimental;7562;84;44;40;551;585;-34;0;6;7568
1987;2821;Arisdorf;1303;Bezirk Liestal;6;VR Alters- und Pflegeregion Liestal;6;VR Alters- und Pflegeregion Liestal;1090;7;8;-1;72;68;4;0;3;1093
1987;2822;Augst;1303;Bezirk Liestal;2;VR APG Rheintal;2;VR APG Rheintal;836;13;11;2;127;134;-7;0;-5;831
1987;2823;Bubendorf;1303;Bezirk Liestal;6;VR Alters- und Pflegeregion Liestal;6;VR Alters- und Pflegeregion Liestal;2837;50;24;26;330;200;130;0;156;2993
1987;2824;Frenkendorf;1303;Bezirk Liestal;6;VR Alters- und Pflegeregion Liestal;6;VR Alters- und Pflegeregion Liestal;5622;75;38;37;563;615;-52;0;-15;5607
1987;2825;Füllinsdorf;1303;Bezirk Liestal;6;VR Alters- und Pflegeregion Liestal;6;VR Alters- und Pflegeregion Liestal;4143;45;22;23;332;387;-55;0;-32;4111
1987;2826;Giebenach;1303;Bezirk Liestal;2;VR APG Rheintal;2;VR APG Rheintal;500;7;2;5;64;21;43;0;48;548
1987;2827;Hersberg;1303;Bezirk Liestal;6;VR Alters- und Pflegeregion Liestal;6;VR Alters- und Pflegeregion Liestal;265;1;1;0;13;14;-1;0;-1;264
1987;2828;Lausen;1303;Bezirk Liestal;6;VR Alters- und Pflegeregion Liestal;6;VR Alters- und Pflegeregion Liestal;3896;51;28;23;360;352;8;1;32;3928
1987;2829;Liestal;1303;Bezirk Liestal;6;VR Alters- und Pflegeregion Liestal;6;VR Alters- und Pflegeregion Liestal;11881;123;87;36;1376;1300;76;0;112;11993
1987;2830;Lupsingen;1303;Bezirk Liestal;6;VR Alters- und Pflegeregion Liestal;6;VR Alters- und Pflegeregion Liestal;976;11;4;7;61;48;13;0;20;996
1987;2831;Pratteln;1303;Bezirk Liestal;2;VR APG Rheintal;2;VR APG Rheintal;15432;164;104;60;1299;1377;-78;0;-18;15414
1987;2832;Ramlinsburg;1303;Bezirk Liestal;10;VR Waldenburgertal plus;8;VR Waldenburgertal plus;389;4;2;2;39;19;20;0;22;411
1987;2833;Seltisberg;1303;Bezirk Liestal;6;VR Alters- und Pflegeregion Liestal;6;VR Alters- und Pflegeregion Liestal;1005;3;2;1;62;62;0;0;1;1006
1987;2834;Ziefen;1303;Bezirk Liestal;6;VR Alters- und Pflegeregion Liestal;6;VR Alters- und Pflegeregion Liestal;1006;11;6;5;64;46;18;0;23;1029
1987;2841;Anwil;1304;Bezirk Sissach;9;VR Farnsberg plus;7;Planungsregion Oberbaselbiet;337;4;3;1;20;22;-2;0;-1;336
1987;2842;Böckten;1304;Bezirk Sissach;7;VR Oberbaselbiet;7;Planungsregion Oberbaselbiet;558;8;6;2;95;48;47;0;49;607
1987;2843;Buckten;1304;Bezirk Sissach;8;VR Oberes Homburgertal;7;Planungsregion Oberbaselbiet;654;11;8;3;39;37;2;0;5;659
1987;2844;Buus;1304;Bezirk Sissach;9;VR Farnsberg plus;7;Planungsregion Oberbaselbiet;759;12;9;3;32;43;-11;0;-8;751
1987;2845;Diepflingen;1304;Bezirk Sissach;7;VR Oberbaselbiet;7;Planungsregion Oberbaselbiet;410;5;5;0;38;45;-7;4;-3;407
1987;2846;Gelterkinden;1304;Bezirk Sissach;7;VR Oberbaselbiet;7;Planungsregion Oberbaselbiet;5185;69;45;24;406;403;3;0;27;5212
1987;2847;Häfelfingen;1304;Bezirk Sissach;8;VR Oberes Homburgertal;7;Planungsregion Oberbaselbiet;231;1;4;-3;26;28;-2;0;-5;226
1987;2848;Hemmiken;1304;Bezirk Sissach;9;VR Farnsberg plus;7;Planungsregion Oberbaselbiet;236;2;6;-4;17;18;-1;0;-5;231
1987;2849;Itingen;1304;Bezirk Sissach;7;VR Oberbaselbiet;7;Planungsregion Oberbaselbiet;1381;21;8;13;124;120;4;0;17;1398
1987;2850;Känerkinden;1304;Bezirk Sissach;8;VR Oberes Homburgertal;7;Planungsregion Oberbaselbiet;381;4;2;2;23;25;-2;0;0;381
1987;2851;Kilchberg (BL);1304;Bezirk Sissach;9;VR Farnsberg plus;7;Planungsregion Oberbaselbiet;114;1;0;1;5;9;-4;0;-3;111
1987;2852;Läufelfingen;1304;Bezirk Sissach;8;VR Oberes Homburgertal;7;Planungsregion Oberbaselbiet;1184;8;14;-6;87;112;-25;0;-31;1153
1987;2853;Maisprach;1304;Bezirk Sissach;9;VR Farnsberg plus;7;Planungsregion Oberbaselbiet;607;11;9;2;23;32;-9;0;-7;600
1987;2854;Nusshof;1304;Bezirk Sissach;7;VR Oberbaselbiet;7;Planungsregion Oberbaselbiet;163;4;4;0;3;2;1;0;1;164
1987;2855;Oltingen;1304;Bezirk Sissach;9;VR Farnsberg plus;7;Planungsregion Oberbaselbiet;333;2;7;-5;27;16;11;0;6;339
1987;2856;Ormalingen;1304;Bezirk Sissach;7;VR Oberbaselbiet;7;Planungsregion Oberbaselbiet;1409;19;12;7;153;137;16;0;23;1432
1987;2857;Rickenbach (BL);1304;Bezirk Sissach;9;VR Farnsberg plus;7;Planungsregion Oberbaselbiet;400;2;5;-3;18;13;5;0;2;402
1987;2858;Rothenfluh;1304;Bezirk Sissach;9;VR Farnsberg plus;7;Planungsregion Oberbaselbiet;625;6;4;2;58;31;27;0;29;654
1987;2859;Rümlingen;1304;Bezirk Sissach;8;VR Oberes Homburgertal;7;Planungsregion Oberbaselbiet;314;3;0;3;25;16;9;0;12;326
1987;2860;Rünenberg;1304;Bezirk Sissach;9;VR Farnsberg plus;7;Planungsregion Oberbaselbiet;558;4;2;2;31;25;6;0;8;566
1987;2861;Sissach;1304;Bezirk Sissach;7;VR Oberbaselbiet;7;Planungsregion Oberbaselbiet;4930;60;45;15;580;485;95;0;110;5040
1987;2862;Tecknau;1304;Bezirk Sissach;7;VR Oberbaselbiet;7;Planungsregion Oberbaselbiet;662;11;6;5;68;64;4;9;18;680
1987;2863;Tenniken;1304;Bezirk Sissach;7;VR Oberbaselbiet;7;Planungsregion Oberbaselbiet;754;13;4;9;114;64;50;0;59;813
1987;2864;Thürnen;1304;Bezirk Sissach;7;VR Oberbaselbiet;7;Planungsregion Oberbaselbiet;944;14;14;0;144;125;19;0;19;963
1987;2865;Wenslingen;1304;Bezirk Sissach;7;VR Oberbaselbiet;7;Planungsregion Oberbaselbiet;557;4;5;-1;29;8;21;0;20;577
1987;2866;Wintersingen;1304;Bezirk Sissach;9;VR Farnsberg plus;7;Planungsregion Oberbaselbiet;475;7;5;2;20;18;2;0;4;479
1987;2867;Wittinsburg;1304;Bezirk Sissach;7;VR Oberbaselbiet;7;Planungsregion Oberbaselbiet;250;1;4;-3;26;11;15;0;12;262
1987;2868;Zeglingen;1304;Bezirk Sissach;9;VR Farnsberg plus;7;Planungsregion Oberbaselbiet;445;0;3;-3;28;31;-3;0;-6;439
1987;2869;Zunzgen;1304;Bezirk Sissach;7;VR Oberbaselbiet;7;Planungsregion Oberbaselbiet;1979;34;11;23;280;156;124;18;165;2144
1987;2881;Arboldswil;1305;Bezirk Waldenburg;10;VR Waldenburgertal plus;8;VR Waldenburgertal plus;399;6;4;2;23;19;4;0;6;405
1987;2882;Bennwil;1305;Bezirk Waldenburg;10;VR Waldenburgertal plus;8;VR Waldenburgertal plus;468;7;4;3;44;20;24;0;27;495
1987;2883;Bretzwil;1305;Bezirk Waldenburg;10;VR Waldenburgertal plus;8;VR Waldenburgertal plus;673;13;8;5;30;22;8;1;14;687
1987;2884;Diegten;1305;Bezirk Waldenburg;7;VR Oberbaselbiet;7;Planungsregion Oberbaselbiet;1031;16;4;12;98;100;-2;0;10;1041
1987;2885;Eptingen;1305;Bezirk Waldenburg;7;VR Oberbaselbiet;7;Planungsregion Oberbaselbiet;560;10;7;3;47;28;19;0;22;582
1987;2886;Hölstein;1305;Bezirk Waldenburg;10;VR Waldenburgertal plus;8;VR Waldenburgertal plus;1673;18;13;5;207;145;62;0;67;1740
1987;2887;Lampenberg;1305;Bezirk Waldenburg;10;VR Waldenburgertal plus;8;VR Waldenburgertal plus;458;3;5;-2;15;16;-1;0;-3;455
1987;2888;Langenbruck;1305;Bezirk Waldenburg;10;VR Waldenburgertal plus;8;VR Waldenburgertal plus;857;12;5;7;136;108;28;0;35;892
1987;2889;Lauwil;1305;Bezirk Waldenburg;10;VR Waldenburgertal plus;8;VR Waldenburgertal plus;293;3;5;-2;17;13;4;0;2;295
1987;2890;Liedertswil;1305;Bezirk Waldenburg;10;VR Waldenburgertal plus;8;VR Waldenburgertal plus;158;3;2;1;7;11;-4;0;-3;155
1987;2891;Niederdorf;1305;Bezirk Waldenburg;10;VR Waldenburgertal plus;8;VR Waldenburgertal plus;1498;19;11;8;115;141;-26;0;-18;1480
1987;2892;Oberdorf (BL);1305;Bezirk Waldenburg;10;VR Waldenburgertal plus;8;VR Waldenburgertal plus;1967;23;21;2;139;130;9;0;11;1978
1987;2893;Reigoldswil;1305;Bezirk Waldenburg;10;VR Waldenburgertal plus;8;VR Waldenburgertal plus;1331;26;9;17;71;81;-10;0;7;1338
1987;2894;Titterten;1305;Bezirk Waldenburg;10;VR Waldenburgertal plus;8;VR Waldenburgertal plus;346;2;2;0;34;17;17;0;17;363
1987;2895;Waldenburg;1305;Bezirk Waldenburg;10;VR Waldenburgertal plus;8;VR Waldenburgertal plus;1192;15;16;-1;104;129;-25;0;-26;1166
1988;2761;Aesch (BL);1301;Bezirk Arlesheim;3;VR Alter Birsstadt;3;VR Alter Birsstadt;9304;132;51;81;1048;853;195;0;276;9580
1988;2762;Allschwil;1301;Bezirk Arlesheim;1;VR Alter und Gesundheit ABS;1;VR Alter und Gesundheit ABS;18665;215;173;42;1601;1401;200;0;242;18907
1988;2763;Arlesheim;1301;Bezirk Arlesheim;3;VR Alter Birsstadt;3;VR Alter Birsstadt;8539;75;86;-11;743;742;1;0;-10;8529
1988;2764;Biel-Benken;1301;Bezirk Arlesheim;4;VR BPA Leimental;4;VR BPA Leimental;2241;21;11;10;156;160;-4;0;6;2247
1988;2765;Binningen;1301;Bezirk Arlesheim;1;VR Alter und Gesundheit ABS;1;VR Alter und Gesundheit ABS;14174;141;124;17;1424;1371;53;0;70;14244
1988;2766;Birsfelden;1301;Bezirk Arlesheim;2;VR APG Rheintal;2;VR APG Rheintal;11988;92;106;-14;803;939;-136;0;-150;11838
1988;2767;Bottmingen;1301;Bezirk Arlesheim;4;VR BPA Leimental;4;VR BPA Leimental;5508;47;39;8;622;502;120;0;128;5636
1988;2768;Ettingen;1301;Bezirk Arlesheim;4;VR BPA Leimental;4;VR BPA Leimental;4855;68;19;49;391;390;1;-1;49;4904
1988;2769;Münchenstein;1301;Bezirk Arlesheim;3;VR Alter Birsstadt;3;VR Alter Birsstadt;11482;130;98;32;836;966;-130;0;-98;11384
1988;2770;Muttenz;1301;Bezirk Arlesheim;2;VR APG Rheintal;2;VR APG Rheintal;17298;180;136;44;901;1180;-279;0;-235;17063
1988;2771;Oberwil (BL);1301;Bezirk Arlesheim;4;VR BPA Leimental;4;VR BPA Leimental;8651;84;46;38;781;821;-40;0;-2;8649
1988;2772;Pfeffingen;1301;Bezirk Arlesheim;3;VR Alter Birsstadt;3;VR Alter Birsstadt;1605;9;11;-2;155;111;44;0;42;1647
1988;2773;Reinach (BL);1301;Bezirk Arlesheim;3;VR Alter Birsstadt;3;VR Alter Birsstadt;18124;199;109;90;1281;1432;-151;0;-61;18063
1988;2774;Schönenbuch;1301;Bezirk Arlesheim;1;VR Alter und Gesundheit ABS;1;VR Alter und Gesundheit ABS;982;12;4;8;99;72;27;-18;17;999
1988;2775;Therwil;1301;Bezirk Arlesheim;4;VR BPA Leimental;4;VR BPA Leimental;7568;96;40;56;525;567;-42;1;15;7583
1988;2821;Arisdorf;1303;Bezirk Liestal;6;VR Alters- und Pflegeregion Liestal;6;VR Alters- und Pflegeregion Liestal;1093;11;9;2;55;60;-5;0;-3;1090
1988;2822;Augst;1303;Bezirk Liestal;2;VR APG Rheintal;2;VR APG Rheintal;831;6;1;5;120;134;-14;0;-9;822
1988;2823;Bubendorf;1303;Bezirk Liestal;6;VR Alters- und Pflegeregion Liestal;6;VR Alters- und Pflegeregion Liestal;2993;30;14;16;353;289;64;0;80;3073
1988;2824;Frenkendorf;1303;Bezirk Liestal;6;VR Alters- und Pflegeregion Liestal;6;VR Alters- und Pflegeregion Liestal;5607;73;24;49;520;533;-13;0;36;5643
1988;2825;Füllinsdorf;1303;Bezirk Liestal;6;VR Alters- und Pflegeregion Liestal;6;VR Alters- und Pflegeregion Liestal;4111;42;20;22;382;419;-37;0;-15;4096
1988;2826;Giebenach;1303;Bezirk Liestal;2;VR APG Rheintal;2;VR APG Rheintal;548;5;3;2;57;27;30;0;32;580
1988;2827;Hersberg;1303;Bezirk Liestal;6;VR Alters- und Pflegeregion Liestal;6;VR Alters- und Pflegeregion Liestal;264;2;4;-2;2;8;-6;0;-8;256
1988;2828;Lausen;1303;Bezirk Liestal;6;VR Alters- und Pflegeregion Liestal;6;VR Alters- und Pflegeregion Liestal;3928;60;19;41;427;322;105;0;146;4074
1988;2829;Liestal;1303;Bezirk Liestal;6;VR Alters- und Pflegeregion Liestal;6;VR Alters- und Pflegeregion Liestal;11993;148;104;44;1477;1460;17;0;61;12054
1988;2830;Lupsingen;1303;Bezirk Liestal;6;VR Alters- und Pflegeregion Liestal;6;VR Alters- und Pflegeregion Liestal;996;6;7;-1;56;63;-7;0;-8;988
1988;2831;Pratteln;1303;Bezirk Liestal;2;VR APG Rheintal;2;VR APG Rheintal;15414;172;103;69;1350;1441;-91;0;-22;15392
1988;2832;Ramlinsburg;1303;Bezirk Liestal;10;VR Waldenburgertal plus;8;VR Waldenburgertal plus;411;3;2;1;49;46;3;0;4;415
1988;2833;Seltisberg;1303;Bezirk Liestal;6;VR Alters- und Pflegeregion Liestal;6;VR Alters- und Pflegeregion Liestal;1006;14;9;5;91;62;29;0;34;1040
1988;2834;Ziefen;1303;Bezirk Liestal;6;VR Alters- und Pflegeregion Liestal;6;VR Alters- und Pflegeregion Liestal;1029;9;11;-2;55;43;12;0;10;1039
1988;2841;Anwil;1304;Bezirk Sissach;9;VR Farnsberg plus;7;Planungsregion Oberbaselbiet;336;8;10;-2;14;31;-17;0;-19;317
1988;2842;Böckten;1304;Bezirk Sissach;7;VR Oberbaselbiet;7;Planungsregion Oberbaselbiet;607;9;9;0;96;68;28;-1;27;634
1988;2843;Buckten;1304;Bezirk Sissach;8;VR Oberes Homburgertal;7;Planungsregion Oberbaselbiet;659;5;5;0;93;74;19;0;19;678
1988;2844;Buus;1304;Bezirk Sissach;9;VR Farnsberg plus;7;Planungsregion Oberbaselbiet;751;8;9;-1;36;35;1;0;0;751
1988;2845;Diepflingen;1304;Bezirk Sissach;7;VR Oberbaselbiet;7;Planungsregion Oberbaselbiet;407;4;4;0;38;38;0;0;0;407
1988;2846;Gelterkinden;1304;Bezirk Sissach;7;VR Oberbaselbiet;7;Planungsregion Oberbaselbiet;5212;54;48;6;371;429;-58;0;-52;5160
1988;2847;Häfelfingen;1304;Bezirk Sissach;8;VR Oberes Homburgertal;7;Planungsregion Oberbaselbiet;226;3;3;0;11;12;-1;0;-1;225
1988;2848;Hemmiken;1304;Bezirk Sissach;9;VR Farnsberg plus;7;Planungsregion Oberbaselbiet;231;2;4;-2;41;20;21;0;19;250
1988;2849;Itingen;1304;Bezirk Sissach;7;VR Oberbaselbiet;7;Planungsregion Oberbaselbiet;1398;20;10;10;129;119;10;0;20;1418
1988;2850;Känerkinden;1304;Bezirk Sissach;8;VR Oberes Homburgertal;7;Planungsregion Oberbaselbiet;381;2;1;1;30;19;11;0;12;393
1988;2851;Kilchberg (BL);1304;Bezirk Sissach;9;VR Farnsberg plus;7;Planungsregion Oberbaselbiet;111;1;2;-1;8;9;-1;0;-2;109
1988;2852;Läufelfingen;1304;Bezirk Sissach;8;VR Oberes Homburgertal;7;Planungsregion Oberbaselbiet;1153;13;10;3;74;82;-8;0;-5;1148
1988;2853;Maisprach;1304;Bezirk Sissach;9;VR Farnsberg plus;7;Planungsregion Oberbaselbiet;600;9;4;5;41;37;4;0;9;609
1988;2854;Nusshof;1304;Bezirk Sissach;7;VR Oberbaselbiet;7;Planungsregion Oberbaselbiet;164;4;0;4;13;18;-5;0;-1;163
1988;2855;Oltingen;1304;Bezirk Sissach;9;VR Farnsberg plus;7;Planungsregion Oberbaselbiet;339;2;3;-1;14;12;2;0;1;340
1988;2856;Ormalingen;1304;Bezirk Sissach;7;VR Oberbaselbiet;7;Planungsregion Oberbaselbiet;1432;19;7;12;122;88;34;0;46;1478
1988;2857;Rickenbach (BL);1304;Bezirk Sissach;9;VR Farnsberg plus;7;Planungsregion Oberbaselbiet;402;7;3;4;26;31;-5;0;-1;401
1988;2858;Rothenfluh;1304;Bezirk Sissach;9;VR Farnsberg plus;7;Planungsregion Oberbaselbiet;654;9;3;6;54;43;11;0;17;671
1988;2859;Rümlingen;1304;Bezirk Sissach;8;VR Oberes Homburgertal;7;Planungsregion Oberbaselbiet;326;2;2;0;30;36;-6;-20;-26;300
1988;2860;Rünenberg;1304;Bezirk Sissach;9;VR Farnsberg plus;7;Planungsregion Oberbaselbiet;566;7;10;-3;18;31;-13;0;-16;550
1988;2861;Sissach;1304;Bezirk Sissach;7;VR Oberbaselbiet;7;Planungsregion Oberbaselbiet;5040;64;44;20;457;468;-11;0;9;5049
1988;2862;Tecknau;1304;Bezirk Sissach;7;VR Oberbaselbiet;7;Planungsregion Oberbaselbiet;680;7;5;2;53;74;-21;0;-19;661
1988;2863;Tenniken;1304;Bezirk Sissach;7;VR Oberbaselbiet;7;Planungsregion Oberbaselbiet;813;13;9;4;67;46;21;0;25;838
1988;2864;Thürnen;1304;Bezirk Sissach;7;VR Oberbaselbiet;7;Planungsregion Oberbaselbiet;963;11;8;3;121;129;-8;0;-5;958
1988;2865;Wenslingen;1304;Bezirk Sissach;7;VR Oberbaselbiet;7;Planungsregion Oberbaselbiet;577;6;3;3;40;33;7;0;10;587
1988;2866;Wintersingen;1304;Bezirk Sissach;9;VR Farnsberg plus;7;Planungsregion Oberbaselbiet;479;4;2;2;22;17;5;0;7;486
1988;2867;Wittinsburg;1304;Bezirk Sissach;7;VR Oberbaselbiet;7;Planungsregion Oberbaselbiet;262;5;0;5;19;24;-5;0;0;262
1988;2868;Zeglingen;1304;Bezirk Sissach;9;VR Farnsberg plus;7;Planungsregion Oberbaselbiet;439;5;6;-1;32;19;13;0;12;451
1988;2869;Zunzgen;1304;Bezirk Sissach;7;VR Oberbaselbiet;7;Planungsregion Oberbaselbiet;2144;33;13;20;225;166;59;0;79;2223
1988;2881;Arboldswil;1305;Bezirk Waldenburg;10;VR Waldenburgertal plus;8;VR Waldenburgertal plus;405;3;2;1;20;16;4;0;5;410
1988;2882;Bennwil;1305;Bezirk Waldenburg;10;VR Waldenburgertal plus;8;VR Waldenburgertal plus;495;7;3;4;63;44;19;0;23;518
1988;2883;Bretzwil;1305;Bezirk Waldenburg;10;VR Waldenburgertal plus;8;VR Waldenburgertal plus;687;10;6;4;36;26;10;0;14;701
1988;2884;Diegten;1305;Bezirk Waldenburg;7;VR Oberbaselbiet;7;Planungsregion Oberbaselbiet;1041;14;5;9;143;102;41;0;50;1091
1988;2885;Eptingen;1305;Bezirk Waldenburg;7;VR Oberbaselbiet;7;Planungsregion Oberbaselbiet;582;7;5;2;35;57;-22;0;-20;562
1988;2886;Hölstein;1305;Bezirk Waldenburg;10;VR Waldenburgertal plus;8;VR Waldenburgertal plus;1740;18;12;6;257;170;87;0;93;1833
1988;2887;Lampenberg;1305;Bezirk Waldenburg;10;VR Waldenburgertal plus;8;VR Waldenburgertal plus;455;5;2;3;24;14;10;0;13;468
1988;2888;Langenbruck;1305;Bezirk Waldenburg;10;VR Waldenburgertal plus;8;VR Waldenburgertal plus;892;11;8;3;125;138;-13;0;-10;882
1988;2889;Lauwil;1305;Bezirk Waldenburg;10;VR Waldenburgertal plus;8;VR Waldenburgertal plus;295;4;2;2;25;17;8;0;10;305
1988;2890;Liedertswil;1305;Bezirk Waldenburg;10;VR Waldenburgertal plus;8;VR Waldenburgertal plus;155;2;1;1;3;6;-3;0;-2;153
1988;2891;Niederdorf;1305;Bezirk Waldenburg;10;VR Waldenburgertal plus;8;VR Waldenburgertal plus;1480;19;9;10;164;100;64;0;74;1554
1988;2892;Oberdorf (BL);1305;Bezirk Waldenburg;10;VR Waldenburgertal plus;8;VR Waldenburgertal plus;1978;17;12;5;180;133;47;-43;9;1987
1988;2893;Reigoldswil;1305;Bezirk Waldenburg;10;VR Waldenburgertal plus;8;VR Waldenburgertal plus;1338;16;14;2;83;81;2;0;4;1342
1988;2894;Titterten;1305;Bezirk Waldenburg;10;VR Waldenburgertal plus;8;VR Waldenburgertal plus;363;1;6;-5;24;13;11;0;6;369
1988;2895;Waldenburg;1305;Bezirk Waldenburg;10;VR Waldenburgertal plus;8;VR Waldenburgertal plus;1166;9;10;-1;125;110;15;0;14;1180
1989;2761;Aesch (BL);1301;Bezirk Arlesheim;3;VR Alter Birsstadt;3;VR Alter Birsstadt;9580;131;54;77;809;848;-39;0;38;9618
1989;2762;Allschwil;1301;Bezirk Arlesheim;1;VR Alter und Gesundheit ABS;1;VR Alter und Gesundheit ABS;18907;188;151;37;1429;1426;3;0;40;18947
1989;2763;Arlesheim;1301;Bezirk Arlesheim;3;VR Alter Birsstadt;3;VR Alter Birsstadt;8529;88;73;15;753;787;-34;0;-19;8510
1989;2764;Biel-Benken;1301;Bezirk Arlesheim;4;VR BPA Leimental;4;VR BPA Leimental;2247;28;13;15;157;159;-2;0;13;2260
1989;2765;Binningen;1301;Bezirk Arlesheim;1;VR Alter und Gesundheit ABS;1;VR Alter und Gesundheit ABS;14244;141;138;3;1294;1259;35;0;38;14282
1989;2766;Birsfelden;1301;Bezirk Arlesheim;2;VR APG Rheintal;2;VR APG Rheintal;11838;111;98;13;846;1041;-195;0;-182;11656
1989;2767;Bottmingen;1301;Bezirk Arlesheim;4;VR BPA Leimental;4;VR BPA Leimental;5636;50;21;29;695;616;79;0;108;5744
1989;2768;Ettingen;1301;Bezirk Arlesheim;4;VR BPA Leimental;4;VR BPA Leimental;4904;51;14;37;354;379;-25;0;12;4916
1989;2769;Münchenstein;1301;Bezirk Arlesheim;3;VR Alter Birsstadt;3;VR Alter Birsstadt;11384;117;103;14;877;835;42;0;56;11440
1989;2770;Muttenz;1301;Bezirk Arlesheim;2;VR APG Rheintal;2;VR APG Rheintal;17063;152;125;27;976;1040;-64;0;-37;17026
1989;2771;Oberwil (BL);1301;Bezirk Arlesheim;4;VR BPA Leimental;4;VR BPA Leimental;8649;88;46;42;743;806;-63;0;-21;8628
1989;2772;Pfeffingen;1301;Bezirk Arlesheim;3;VR Alter Birsstadt;3;VR Alter Birsstadt;1647;5;6;-1;132;135;-3;0;-4;1643
1989;2773;Reinach (BL);1301;Bezirk Arlesheim;3;VR Alter Birsstadt;3;VR Alter Birsstadt;18063;166;112;54;1343;1279;64;0;118;18181
1989;2774;Schönenbuch;1301;Bezirk Arlesheim;1;VR Alter und Gesundheit ABS;1;VR Alter und Gesundheit ABS;999;14;6;8;43;39;4;0;12;1011
1989;2775;Therwil;1301;Bezirk Arlesheim;4;VR BPA Leimental;4;VR BPA Leimental;7583;83;42;41;570;559;11;0;52;7635
1989;2821;Arisdorf;1303;Bezirk Liestal;6;VR Alters- und Pflegeregion Liestal;6;VR Alters- und Pflegeregion Liestal;1090;10;18;-8;62;75;-13;0;-21;1069
1989;2822;Augst;1303;Bezirk Liestal;2;VR APG Rheintal;2;VR APG Rheintal;822;11;7;4;108;131;-23;0;-19;803
1989;2823;Bubendorf;1303;Bezirk Liestal;6;VR Alters- und Pflegeregion Liestal;6;VR Alters- und Pflegeregion Liestal;3073;73;26;47;377;341;36;1;84;3157
1989;2824;Frenkendorf;1303;Bezirk Liestal;6;VR Alters- und Pflegeregion Liestal;6;VR Alters- und Pflegeregion Liestal;5643;77;45;32;527;597;-70;-2;-40;5603
1989;2825;Füllinsdorf;1303;Bezirk Liestal;6;VR Alters- und Pflegeregion Liestal;6;VR Alters- und Pflegeregion Liestal;4096;37;19;18;338;388;-50;0;-32;4064
1989;2826;Giebenach;1303;Bezirk Liestal;2;VR APG Rheintal;2;VR APG Rheintal;580;10;2;8;52;33;19;0;27;607
1989;2827;Hersberg;1303;Bezirk Liestal;6;VR Alters- und Pflegeregion Liestal;6;VR Alters- und Pflegeregion Liestal;256;2;0;2;13;13;0;0;2;258
1989;2828;Lausen;1303;Bezirk Liestal;6;VR Alters- und Pflegeregion Liestal;6;VR Alters- und Pflegeregion Liestal;4074;66;20;46;437;386;51;0;97;4171
1989;2829;Liestal;1303;Bezirk Liestal;6;VR Alters- und Pflegeregion Liestal;6;VR Alters- und Pflegeregion Liestal;12054;140;99;41;1322;1237;85;0;126;12180
1989;2830;Lupsingen;1303;Bezirk Liestal;6;VR Alters- und Pflegeregion Liestal;6;VR Alters- und Pflegeregion Liestal;988;8;2;6;53;58;-5;0;1;989
1989;2831;Pratteln;1303;Bezirk Liestal;2;VR APG Rheintal;2;VR APG Rheintal;15392;191;99;92;1323;1354;-31;0;61;15453
1989;2832;Ramlinsburg;1303;Bezirk Liestal;10;VR Waldenburgertal plus;8;VR Waldenburgertal plus;415;6;3;3;60;40;20;0;23;438
1989;2833;Seltisberg;1303;Bezirk Liestal;6;VR Alters- und Pflegeregion Liestal;6;VR Alters- und Pflegeregion Liestal;1040;8;7;1;89;73;16;0;17;1057
1989;2834;Ziefen;1303;Bezirk Liestal;6;VR Alters- und Pflegeregion Liestal;6;VR Alters- und Pflegeregion Liestal;1039;14;8;6;67;50;17;0;23;1062
1989;2841;Anwil;1304;Bezirk Sissach;9;VR Farnsberg plus;7;Planungsregion Oberbaselbiet;317;3;4;-1;27;11;16;0;15;332
1989;2842;Böckten;1304;Bezirk Sissach;7;VR Oberbaselbiet;7;Planungsregion Oberbaselbiet;634;11;4;7;97;46;51;0;58;692
1989;2843;Buckten;1304;Bezirk Sissach;8;VR Oberes Homburgertal;7;Planungsregion Oberbaselbiet;678;10;1;9;56;60;-4;0;5;683
1989;2844;Buus;1304;Bezirk Sissach;9;VR Farnsberg plus;7;Planungsregion Oberbaselbiet;751;13;5;8;61;38;23;0;31;782
1989;2845;Diepflingen;1304;Bezirk Sissach;7;VR Oberbaselbiet;7;Planungsregion Oberbaselbiet;407;7;6;1;32;28;4;0;5;412
1989;2846;Gelterkinden;1304;Bezirk Sissach;7;VR Oberbaselbiet;7;Planungsregion Oberbaselbiet;5160;54;47;7;428;409;19;0;26;5186
1989;2847;Häfelfingen;1304;Bezirk Sissach;8;VR Oberes Homburgertal;7;Planungsregion Oberbaselbiet;225;1;2;-1;28;22;6;0;5;230
1989;2848;Hemmiken;1304;Bezirk Sissach;9;VR Farnsberg plus;7;Planungsregion Oberbaselbiet;250;5;1;4;30;24;6;0;10;260
1989;2849;Itingen;1304;Bezirk Sissach;7;VR Oberbaselbiet;7;Planungsregion Oberbaselbiet;1418;16;14;2;141;154;-13;0;-11;1407
1989;2850;Känerkinden;1304;Bezirk Sissach;8;VR Oberes Homburgertal;7;Planungsregion Oberbaselbiet;393;7;1;6;15;18;-3;0;3;396
1989;2851;Kilchberg (BL);1304;Bezirk Sissach;9;VR Farnsberg plus;7;Planungsregion Oberbaselbiet;109;1;0;1;6;13;-7;0;-6;103
1989;2852;Läufelfingen;1304;Bezirk Sissach;8;VR Oberes Homburgertal;7;Planungsregion Oberbaselbiet;1148;11;12;-1;72;55;17;0;16;1164
1989;2853;Maisprach;1304;Bezirk Sissach;9;VR Farnsberg plus;7;Planungsregion Oberbaselbiet;609;4;2;2;62;30;32;0;34;643
1989;2854;Nusshof;1304;Bezirk Sissach;7;VR Oberbaselbiet;7;Planungsregion Oberbaselbiet;163;1;1;0;8;14;-6;0;-6;157
1989;2855;Oltingen;1304;Bezirk Sissach;9;VR Farnsberg plus;7;Planungsregion Oberbaselbiet;340;4;6;-2;23;14;9;0;7;347
1989;2856;Ormalingen;1304;Bezirk Sissach;7;VR Oberbaselbiet;7;Planungsregion Oberbaselbiet;1478;12;12;0;125;135;-10;0;-10;1468
1989;2857;Rickenbach (BL);1304;Bezirk Sissach;9;VR Farnsberg plus;7;Planungsregion Oberbaselbiet;401;4;3;1;22;12;10;0;11;412
1989;2858;Rothenfluh;1304;Bezirk Sissach;9;VR Farnsberg plus;7;Planungsregion Oberbaselbiet;671;13;9;4;50;54;-4;0;0;671
1989;2859;Rümlingen;1304;Bezirk Sissach;8;VR Oberes Homburgertal;7;Planungsregion Oberbaselbiet;300;3;6;-3;30;18;12;0;9;309
1989;2860;Rünenberg;1304;Bezirk Sissach;9;VR Farnsberg plus;7;Planungsregion Oberbaselbiet;550;7;4;3;34;25;9;0;12;562
1989;2861;Sissach;1304;Bezirk Sissach;7;VR Oberbaselbiet;7;Planungsregion Oberbaselbiet;5049;68;44;24;455;492;-37;0;-13;5036
1989;2862;Tecknau;1304;Bezirk Sissach;7;VR Oberbaselbiet;7;Planungsregion Oberbaselbiet;661;11;2;9;51;77;-26;0;-17;644
1989;2863;Tenniken;1304;Bezirk Sissach;7;VR Oberbaselbiet;7;Planungsregion Oberbaselbiet;838;16;2;14;44;48;-4;-1;9;847
1989;2864;Thürnen;1304;Bezirk Sissach;7;VR Oberbaselbiet;7;Planungsregion Oberbaselbiet;958;18;7;11;132;135;-3;0;8;966
1989;2865;Wenslingen;1304;Bezirk Sissach;7;VR Oberbaselbiet;7;Planungsregion Oberbaselbiet;587;6;3;3;39;24;15;0;18;605
1989;2866;Wintersingen;1304;Bezirk Sissach;9;VR Farnsberg plus;7;Planungsregion Oberbaselbiet;486;7;4;3;22;26;-4;0;-1;485
1989;2867;Wittinsburg;1304;Bezirk Sissach;7;VR Oberbaselbiet;7;Planungsregion Oberbaselbiet;262;4;2;2;22;12;10;0;12;274
1989;2868;Zeglingen;1304;Bezirk Sissach;9;VR Farnsberg plus;7;Planungsregion Oberbaselbiet;451;5;5;0;37;37;0;2;2;453
1989;2869;Zunzgen;1304;Bezirk Sissach;7;VR Oberbaselbiet;7;Planungsregion Oberbaselbiet;2223;21;18;3;239;158;81;0;84;2307
1989;2881;Arboldswil;1305;Bezirk Waldenburg;10;VR Waldenburgertal plus;8;VR Waldenburgertal plus;410;4;5;-1;16;17;-1;0;-2;408
1989;2882;Bennwil;1305;Bezirk Waldenburg;10;VR Waldenburgertal plus;8;VR Waldenburgertal plus;518;6;4;2;32;29;3;0;5;523
1989;2883;Bretzwil;1305;Bezirk Waldenburg;10;VR Waldenburgertal plus;8;VR Waldenburgertal plus;701;8;5;3;39;52;-13;0;-10;691
1989;2884;Diegten;1305;Bezirk Waldenburg;7;VR Oberbaselbiet;7;Planungsregion Oberbaselbiet;1091;20;3;17;116;117;-1;0;16;1107
1989;2885;Eptingen;1305;Bezirk Waldenburg;7;VR Oberbaselbiet;7;Planungsregion Oberbaselbiet;562;7;6;1;47;46;1;0;2;564
1989;2886;Hölstein;1305;Bezirk Waldenburg;10;VR Waldenburgertal plus;8;VR Waldenburgertal plus;1833;35;14;21;209;158;51;0;72;1905
1989;2887;Lampenberg;1305;Bezirk Waldenburg;10;VR Waldenburgertal plus;8;VR Waldenburgertal plus;468;4;0;4;15;26;-11;0;-7;461
1989;2888;Langenbruck;1305;Bezirk Waldenburg;10;VR Waldenburgertal plus;8;VR Waldenburgertal plus;882;9;3;6;123;118;5;0;11;893
1989;2889;Lauwil;1305;Bezirk Waldenburg;10;VR Waldenburgertal plus;8;VR Waldenburgertal plus;305;1;2;-1;19;11;8;0;7;312
1989;2890;Liedertswil;1305;Bezirk Waldenburg;10;VR Waldenburgertal plus;8;VR Waldenburgertal plus;153;3;1;2;10;9;1;0;3;156
1989;2891;Niederdorf;1305;Bezirk Waldenburg;10;VR Waldenburgertal plus;8;VR Waldenburgertal plus;1554;14;17;-3;131;117;14;0;11;1565
1989;2892;Oberdorf (BL);1305;Bezirk Waldenburg;10;VR Waldenburgertal plus;8;VR Waldenburgertal plus;1987;19;19;0;172;150;22;0;22;2009
1989;2893;Reigoldswil;1305;Bezirk Waldenburg;10;VR Waldenburgertal plus;8;VR Waldenburgertal plus;1342;14;15;-1;100;92;8;0;7;1349
1989;2894;Titterten;1305;Bezirk Waldenburg;10;VR Waldenburgertal plus;8;VR Waldenburgertal plus;369;3;4;-1;33;16;17;0;16;385
1989;2895;Waldenburg;1305;Bezirk Waldenburg;10;VR Waldenburgertal plus;8;VR Waldenburgertal plus;1180;12;13;-1;160;110;50;0;49;1229
1990;2761;Aesch (BL);1301;Bezirk Arlesheim;3;VR Alter Birsstadt;3;VR Alter Birsstadt;9618;124;63;61;786;846;-60;-1;0;9618
1990;2762;Allschwil;1301;Bezirk Arlesheim;1;VR Alter und Gesundheit ABS;1;VR Alter und Gesundheit ABS;18947;176;158;18;1409;1377;32;0;50;18997
1990;2763;Arlesheim;1301;Bezirk Arlesheim;3;VR Alter Birsstadt;3;VR Alter Birsstadt;8510;64;71;-7;677;671;6;0;-1;8509
1990;2764;Biel-Benken;1301;Bezirk Arlesheim;4;VR BPA Leimental;4;VR BPA Leimental;2260;10;12;-2;192;113;79;0;77;2337
1990;2765;Binningen;1301;Bezirk Arlesheim;1;VR Alter und Gesundheit ABS;1;VR Alter und Gesundheit ABS;14282;151;140;11;1328;1336;-8;0;3;14285
1990;2766;Birsfelden;1301;Bezirk Arlesheim;2;VR APG Rheintal;2;VR APG Rheintal;11656;113;116;-3;843;818;25;0;22;11678
1990;2767;Bottmingen;1301;Bezirk Arlesheim;4;VR BPA Leimental;4;VR BPA Leimental;5744;55;37;18;638;598;40;0;58;5802
1990;2768;Ettingen;1301;Bezirk Arlesheim;4;VR BPA Leimental;4;VR BPA Leimental;4916;65;16;49;367;403;-36;0;13;4929
1990;2769;Münchenstein;1301;Bezirk Arlesheim;3;VR Alter Birsstadt;3;VR Alter Birsstadt;11440;135;106;29;940;825;115;0;144;11584
1990;2770;Muttenz;1301;Bezirk Arlesheim;2;VR APG Rheintal;2;VR APG Rheintal;17026;172;129;43;968;1050;-82;0;-39;16987
1990;2771;Oberwil (BL);1301;Bezirk Arlesheim;4;VR BPA Leimental;4;VR BPA Leimental;8628;89;62;27;816;740;76;0;103;8731
1990;2772;Pfeffingen;1301;Bezirk Arlesheim;3;VR Alter Birsstadt;3;VR Alter Birsstadt;1643;12;4;8;121;118;3;0;11;1654
1990;2773;Reinach (BL);1301;Bezirk Arlesheim;3;VR Alter Birsstadt;3;VR Alter Birsstadt;18181;187;136;51;1185;1124;61;0;112;18293
1990;2774;Schönenbuch;1301;Bezirk Arlesheim;1;VR Alter und Gesundheit ABS;1;VR Alter und Gesundheit ABS;1011;12;5;7;44;38;6;0;13;1024
1990;2775;Therwil;1301;Bezirk Arlesheim;4;VR BPA Leimental;4;VR BPA Leimental;7635;64;49;15;500;510;-10;0;5;7640
1990;2821;Arisdorf;1303;Bezirk Liestal;6;VR Alters- und Pflegeregion Liestal;6;VR Alters- und Pflegeregion Liestal;1069;14;10;4;107;64;43;0;47;1116
1990;2822;Augst;1303;Bezirk Liestal;2;VR APG Rheintal;2;VR APG Rheintal;803;8;2;6;133;119;14;0;20;823
1990;2823;Bubendorf;1303;Bezirk Liestal;6;VR Alters- und Pflegeregion Liestal;6;VR Alters- und Pflegeregion Liestal;3157;38;15;23;374;333;41;0;64;3221
1990;2824;Frenkendorf;1303;Bezirk Liestal;6;VR Alters- und Pflegeregion Liestal;6;VR Alters- und Pflegeregion Liestal;5603;74;36;38;488;500;-12;0;26;5629
1990;2825;Füllinsdorf;1303;Bezirk Liestal;6;VR Alters- und Pflegeregion Liestal;6;VR Alters- und Pflegeregion Liestal;4064;32;27;5;279;313;-34;0;-29;4035
1990;2826;Giebenach;1303;Bezirk Liestal;2;VR APG Rheintal;2;VR APG Rheintal;607;7;1;6;29;29;0;0;6;613
1990;2827;Hersberg;1303;Bezirk Liestal;6;VR Alters- und Pflegeregion Liestal;6;VR Alters- und Pflegeregion Liestal;258;3;1;2;9;7;2;0;4;262
1990;2828;Lausen;1303;Bezirk Liestal;6;VR Alters- und Pflegeregion Liestal;6;VR Alters- und Pflegeregion Liestal;4171;66;42;24;470;358;112;0;136;4307
1990;2829;Liestal;1303;Bezirk Liestal;6;VR Alters- und Pflegeregion Liestal;6;VR Alters- und Pflegeregion Liestal;12180;128;123;5;1506;1368;138;1;144;12324
1990;2830;Lupsingen;1303;Bezirk Liestal;6;VR Alters- und Pflegeregion Liestal;6;VR Alters- und Pflegeregion Liestal;989;11;9;2;37;31;6;0;8;997
1990;2831;Pratteln;1303;Bezirk Liestal;2;VR APG Rheintal;2;VR APG Rheintal;15453;170;108;62;1253;1384;-131;0;-69;15384
1990;2832;Ramlinsburg;1303;Bezirk Liestal;10;VR Waldenburgertal plus;8;VR Waldenburgertal plus;438;10;2;8;47;41;6;0;14;452
1990;2833;Seltisberg;1303;Bezirk Liestal;6;VR Alters- und Pflegeregion Liestal;6;VR Alters- und Pflegeregion Liestal;1057;9;11;-2;104;98;6;0;4;1061
1990;2834;Ziefen;1303;Bezirk Liestal;6;VR Alters- und Pflegeregion Liestal;6;VR Alters- und Pflegeregion Liestal;1062;16;10;6;53;48;5;0;11;1073
1990;2841;Anwil;1304;Bezirk Sissach;9;VR Farnsberg plus;7;Planungsregion Oberbaselbiet;332;8;6;2;23;27;-4;0;-2;330
1990;2842;Böckten;1304;Bezirk Sissach;7;VR Oberbaselbiet;7;Planungsregion Oberbaselbiet;692;12;10;2;68;57;11;0;13;705
1990;2843;Buckten;1304;Bezirk Sissach;8;VR Oberes Homburgertal;7;Planungsregion Oberbaselbiet;683;15;3;12;69;53;16;0;28;711
1990;2844;Buus;1304;Bezirk Sissach;9;VR Farnsberg plus;7;Planungsregion Oberbaselbiet;782;4;8;-4;46;75;-29;0;-33;749
1990;2845;Diepflingen;1304;Bezirk Sissach;7;VR Oberbaselbiet;7;Planungsregion Oberbaselbiet;412;7;6;1;29;34;-5;0;-4;408
1990;2846;Gelterkinden;1304;Bezirk Sissach;7;VR Oberbaselbiet;7;Planungsregion Oberbaselbiet;5186;55;52;3;388;399;-11;0;-8;5178
1990;2847;Häfelfingen;1304;Bezirk Sissach;8;VR Oberes Homburgertal;7;Planungsregion Oberbaselbiet;230;6;2;4;27;23;4;0;8;238
1990;2848;Hemmiken;1304;Bezirk Sissach;9;VR Farnsberg plus;7;Planungsregion Oberbaselbiet;260;3;2;1;17;10;7;0;8;268
1990;2849;Itingen;1304;Bezirk Sissach;7;VR Oberbaselbiet;7;Planungsregion Oberbaselbiet;1407;13;7;6;135;114;21;0;27;1434
1990;2850;Känerkinden;1304;Bezirk Sissach;8;VR Oberes Homburgertal;7;Planungsregion Oberbaselbiet;396;5;5;0;28;19;9;0;9;405
1990;2851;Kilchberg (BL);1304;Bezirk Sissach;9;VR Farnsberg plus;7;Planungsregion Oberbaselbiet;103;1;1;0;4;3;1;0;1;104
1990;2852;Läufelfingen;1304;Bezirk Sissach;8;VR Oberes Homburgertal;7;Planungsregion Oberbaselbiet;1164;22;9;13;84;63;21;0;34;1198
1990;2853;Maisprach;1304;Bezirk Sissach;9;VR Farnsberg plus;7;Planungsregion Oberbaselbiet;643;17;2;15;60;45;15;0;30;673
1990;2854;Nusshof;1304;Bezirk Sissach;7;VR Oberbaselbiet;7;Planungsregion Oberbaselbiet;157;3;0;3;32;13;19;0;22;179
1990;2855;Oltingen;1304;Bezirk Sissach;9;VR Farnsberg plus;7;Planungsregion Oberbaselbiet;347;8;6;2;26;20;6;0;8;355
1990;2856;Ormalingen;1304;Bezirk Sissach;7;VR Oberbaselbiet;7;Planungsregion Oberbaselbiet;1468;14;8;6;137;99;38;0;44;1512
1990;2857;Rickenbach (BL);1304;Bezirk Sissach;9;VR Farnsberg plus;7;Planungsregion Oberbaselbiet;412;6;5;1;58;19;39;0;40;452
1990;2858;Rothenfluh;1304;Bezirk Sissach;9;VR Farnsberg plus;7;Planungsregion Oberbaselbiet;671;9;7;2;24;37;-13;0;-11;660
1990;2859;Rümlingen;1304;Bezirk Sissach;8;VR Oberes Homburgertal;7;Planungsregion Oberbaselbiet;309;0;3;-3;36;30;6;0;3;312
1990;2860;Rünenberg;1304;Bezirk Sissach;9;VR Farnsberg plus;7;Planungsregion Oberbaselbiet;562;6;6;0;16;24;-8;0;-8;554
1990;2861;Sissach;1304;Bezirk Sissach;7;VR Oberbaselbiet;7;Planungsregion Oberbaselbiet;5036;57;35;22;522;481;41;1;64;5100
1990;2862;Tecknau;1304;Bezirk Sissach;7;VR Oberbaselbiet;7;Planungsregion Oberbaselbiet;644;13;9;4;102;80;22;0;26;670
1990;2863;Tenniken;1304;Bezirk Sissach;7;VR Oberbaselbiet;7;Planungsregion Oberbaselbiet;847;8;9;-1;64;63;1;0;0;847
1990;2864;Thürnen;1304;Bezirk Sissach;7;VR Oberbaselbiet;7;Planungsregion Oberbaselbiet;966;14;4;10;148;128;20;0;30;996
1990;2865;Wenslingen;1304;Bezirk Sissach;7;VR Oberbaselbiet;7;Planungsregion Oberbaselbiet;605;9;6;3;41;31;10;0;13;618
1990;2866;Wintersingen;1304;Bezirk Sissach;9;VR Farnsberg plus;7;Planungsregion Oberbaselbiet;485;4;4;0;58;34;24;0;24;509
1990;2867;Wittinsburg;1304;Bezirk Sissach;7;VR Oberbaselbiet;7;Planungsregion Oberbaselbiet;274;4;3;1;26;19;7;0;8;282
1990;2868;Zeglingen;1304;Bezirk Sissach;9;VR Farnsberg plus;7;Planungsregion Oberbaselbiet;453;6;5;1;28;23;5;0;6;459
1990;2869;Zunzgen;1304;Bezirk Sissach;7;VR Oberbaselbiet;7;Planungsregion Oberbaselbiet;2307;32;16;16;180;161;19;0;35;2342
1990;2881;Arboldswil;1305;Bezirk Waldenburg;10;VR Waldenburgertal plus;8;VR Waldenburgertal plus;408;0;0;0;26;20;6;0;6;414
1990;2882;Bennwil;1305;Bezirk Waldenburg;10;VR Waldenburgertal plus;8;VR Waldenburgertal plus;523;4;2;2;37;29;8;0;10;533
1990;2883;Bretzwil;1305;Bezirk Waldenburg;10;VR Waldenburgertal plus;8;VR Waldenburgertal plus;691;5;7;-2;56;49;7;0;5;696
1990;2884;Diegten;1305;Bezirk Waldenburg;7;VR Oberbaselbiet;7;Planungsregion Oberbaselbiet;1107;22;10;12;105;94;11;0;23;1130
1990;2885;Eptingen;1305;Bezirk Waldenburg;7;VR Oberbaselbiet;7;Planungsregion Oberbaselbiet;564;6;1;5;43;65;-22;0;-17;547
1990;2886;Hölstein;1305;Bezirk Waldenburg;10;VR Waldenburgertal plus;8;VR Waldenburgertal plus;1905;19;7;12;208;135;73;0;85;1990
1990;2887;Lampenberg;1305;Bezirk Waldenburg;10;VR Waldenburgertal plus;8;VR Waldenburgertal plus;461;7;4;3;11;19;-8;0;-5;456
1990;2888;Langenbruck;1305;Bezirk Waldenburg;10;VR Waldenburgertal plus;8;VR Waldenburgertal plus;893;10;3;7;125;97;28;0;35;928
1990;2889;Lauwil;1305;Bezirk Waldenburg;10;VR Waldenburgertal plus;8;VR Waldenburgertal plus;312;5;4;1;38;21;17;0;18;330
1990;2890;Liedertswil;1305;Bezirk Waldenburg;10;VR Waldenburgertal plus;8;VR Waldenburgertal plus;156;1;3;-2;13;17;-4;0;-6;150
1990;2891;Niederdorf;1305;Bezirk Waldenburg;10;VR Waldenburgertal plus;8;VR Waldenburgertal plus;1565;15;15;0;138;107;31;1;32;1597
1990;2892;Oberdorf (BL);1305;Bezirk Waldenburg;10;VR Waldenburgertal plus;8;VR Waldenburgertal plus;2009;18;25;-7;182;162;20;0;13;2022
1990;2893;Reigoldswil;1305;Bezirk Waldenburg;10;VR Waldenburgertal plus;8;VR Waldenburgertal plus;1349;15;10;5;97;75;22;0;27;1376
1990;2894;Titterten;1305;Bezirk Waldenburg;10;VR Waldenburgertal plus;8;VR Waldenburgertal plus;385;5;2;3;27;30;-3;0;0;385
1990;2895;Waldenburg;1305;Bezirk Waldenburg;10;VR Waldenburgertal plus;8;VR Waldenburgertal plus;1229;13;12;1;119;95;24;0;25;1254
1991;2761;Aesch (BL);1301;Bezirk Arlesheim;3;VR Alter Birsstadt;3;VR Alter Birsstadt;9618;114;47;67;736;770;-34;1;34;9652
1991;2762;Allschwil;1301;Bezirk Arlesheim;1;VR Alter und Gesundheit ABS;1;VR Alter und Gesundheit ABS;18997;173;164;9;1463;1347;116;0;125;19122
1991;2763;Arlesheim;1301;Bezirk Arlesheim;3;VR Alter Birsstadt;3;VR Alter Birsstadt;8509;96;99;-3;537;593;-56;1;-58;8451
1991;2764;Biel-Benken;1301;Bezirk Arlesheim;4;VR BPA Leimental;4;VR BPA Leimental;2337;18;8;10;183;206;-23;0;-13;2324
1991;2765;Binningen;1301;Bezirk Arlesheim;1;VR Alter und Gesundheit ABS;1;VR Alter und Gesundheit ABS;14285;120;136;-16;1105;1105;0;3;-13;14272
1991;2766;Birsfelden;1301;Bezirk Arlesheim;2;VR APG Rheintal;2;VR APG Rheintal;11678;104;111;-7;726;769;-43;0;-50;11628
1991;2767;Bottmingen;1301;Bezirk Arlesheim;4;VR BPA Leimental;4;VR BPA Leimental;5802;42;33;9;616;637;-21;0;-12;5790
1991;2768;Ettingen;1301;Bezirk Arlesheim;4;VR BPA Leimental;4;VR BPA Leimental;4929;55;19;36;329;350;-21;0;15;4944
1991;2769;Münchenstein;1301;Bezirk Arlesheim;3;VR Alter Birsstadt;3;VR Alter Birsstadt;11584;122;110;12;781;727;54;0;66;11650
1991;2770;Muttenz;1301;Bezirk Arlesheim;2;VR APG Rheintal;2;VR APG Rheintal;16987;161;124;37;834;942;-108;0;-71;16916
1991;2771;Oberwil (BL);1301;Bezirk Arlesheim;4;VR BPA Leimental;4;VR BPA Leimental;8731;75;61;14;778;689;89;0;103;8834
1991;2772;Pfeffingen;1301;Bezirk Arlesheim;3;VR Alter Birsstadt;3;VR Alter Birsstadt;1654;15;8;7;134;121;13;0;20;1674
1991;2773;Reinach (BL);1301;Bezirk Arlesheim;3;VR Alter Birsstadt;3;VR Alter Birsstadt;18293;156;99;57;1101;1146;-45;0;12;18305
1991;2774;Schönenbuch;1301;Bezirk Arlesheim;1;VR Alter und Gesundheit ABS;1;VR Alter und Gesundheit ABS;1024;15;3;12;69;55;14;0;26;1050
1991;2775;Therwil;1301;Bezirk Arlesheim;4;VR BPA Leimental;4;VR BPA Leimental;7640;68;34;34;538;524;14;0;48;7688
1991;2821;Arisdorf;1303;Bezirk Liestal;6;VR Alters- und Pflegeregion Liestal;6;VR Alters- und Pflegeregion Liestal;1116;8;18;-10;67;76;-9;0;-19;1097
1991;2822;Augst;1303;Bezirk Liestal;2;VR APG Rheintal;2;VR APG Rheintal;823;9;7;2;103;131;-28;0;-26;797
1991;2823;Bubendorf;1303;Bezirk Liestal;6;VR Alters- und Pflegeregion Liestal;6;VR Alters- und Pflegeregion Liestal;3221;44;16;28;330;241;89;0;117;3338
1991;2824;Frenkendorf;1303;Bezirk Liestal;6;VR Alters- und Pflegeregion Liestal;6;VR Alters- und Pflegeregion Liestal;5629;57;56;1;492;459;33;1;35;5664
1991;2825;Füllinsdorf;1303;Bezirk Liestal;6;VR Alters- und Pflegeregion Liestal;6;VR Alters- und Pflegeregion Liestal;4035;44;25;19;291;340;-49;0;-30;4005
1991;2826;Giebenach;1303;Bezirk Liestal;2;VR APG Rheintal;2;VR APG Rheintal;613;14;4;10;41;34;7;0;17;630
1991;2827;Hersberg;1303;Bezirk Liestal;6;VR Alters- und Pflegeregion Liestal;6;VR Alters- und Pflegeregion Liestal;262;0;2;-2;9;13;-4;0;-6;256
1991;2828;Lausen;1303;Bezirk Liestal;6;VR Alters- und Pflegeregion Liestal;6;VR Alters- und Pflegeregion Liestal;4307;55;26;29;345;295;50;0;79;4386
1991;2829;Liestal;1303;Bezirk Liestal;6;VR Alters- und Pflegeregion Liestal;6;VR Alters- und Pflegeregion Liestal;12324;144;107;37;1345;1193;152;2;191;12515
1991;2830;Lupsingen;1303;Bezirk Liestal;6;VR Alters- und Pflegeregion Liestal;6;VR Alters- und Pflegeregion Liestal;997;9;8;1;39;36;3;0;4;1001
1991;2831;Pratteln;1303;Bezirk Liestal;2;VR APG Rheintal;2;VR APG Rheintal;15384;176;114;62;1386;1232;154;1;217;15601
1991;2832;Ramlinsburg;1303;Bezirk Liestal;10;VR Waldenburgertal plus;8;VR Waldenburgertal plus;452;4;3;1;46;24;22;0;23;475
1991;2833;Seltisberg;1303;Bezirk Liestal;6;VR Alters- und Pflegeregion Liestal;6;VR Alters- und Pflegeregion Liestal;1061;5;7;-2;85;94;-9;0;-11;1050
1991;2834;Ziefen;1303;Bezirk Liestal;6;VR Alters- und Pflegeregion Liestal;6;VR Alters- und Pflegeregion Liestal;1073;18;9;9;101;37;64;0;73;1146
1991;2841;Anwil;1304;Bezirk Sissach;9;VR Farnsberg plus;7;Planungsregion Oberbaselbiet;330;8;1;7;26;10;16;0;23;353
1991;2842;Böckten;1304;Bezirk Sissach;7;VR Oberbaselbiet;7;Planungsregion Oberbaselbiet;705;12;2;10;72;56;16;0;26;731
1991;2843;Buckten;1304;Bezirk Sissach;8;VR Oberes Homburgertal;7;Planungsregion Oberbaselbiet;711;6;6;0;55;70;-15;0;-15;696
1991;2844;Buus;1304;Bezirk Sissach;9;VR Farnsberg plus;7;Planungsregion Oberbaselbiet;749;11;4;7;61;32;29;0;36;785
1991;2845;Diepflingen;1304;Bezirk Sissach;7;VR Oberbaselbiet;7;Planungsregion Oberbaselbiet;408;8;2;6;43;38;5;0;11;419
1991;2846;Gelterkinden;1304;Bezirk Sissach;7;VR Oberbaselbiet;7;Planungsregion Oberbaselbiet;5178;76;51;25;385;367;18;0;43;5221
1991;2847;Häfelfingen;1304;Bezirk Sissach;8;VR Oberes Homburgertal;7;Planungsregion Oberbaselbiet;238;2;3;-1;26;13;13;0;12;250
1991;2848;Hemmiken;1304;Bezirk Sissach;9;VR Farnsberg plus;7;Planungsregion Oberbaselbiet;268;2;3;-1;23;14;9;0;8;276
1991;2849;Itingen;1304;Bezirk Sissach;7;VR Oberbaselbiet;7;Planungsregion Oberbaselbiet;1434;14;8;6;102;102;0;0;6;1440
1991;2850;Känerkinden;1304;Bezirk Sissach;8;VR Oberes Homburgertal;7;Planungsregion Oberbaselbiet;405;4;1;3;39;33;6;0;9;414
1991;2851;Kilchberg (BL);1304;Bezirk Sissach;9;VR Farnsberg plus;7;Planungsregion Oberbaselbiet;104;0;1;-1;2;3;-1;0;-2;102
1991;2852;Läufelfingen;1304;Bezirk Sissach;8;VR Oberes Homburgertal;7;Planungsregion Oberbaselbiet;1198;11;6;5;63;44;19;0;24;1222
1991;2853;Maisprach;1304;Bezirk Sissach;9;VR Farnsberg plus;7;Planungsregion Oberbaselbiet;673;14;4;10;65;43;22;0;32;705
1991;2854;Nusshof;1304;Bezirk Sissach;7;VR Oberbaselbiet;7;Planungsregion Oberbaselbiet;179;3;1;2;6;6;0;0;2;181
1991;2855;Oltingen;1304;Bezirk Sissach;9;VR Farnsberg plus;7;Planungsregion Oberbaselbiet;355;5;2;3;14;6;8;0;11;366
1991;2856;Ormalingen;1304;Bezirk Sissach;7;VR Oberbaselbiet;7;Planungsregion Oberbaselbiet;1512;24;13;11;135;98;37;0;48;1560
1991;2857;Rickenbach (BL);1304;Bezirk Sissach;9;VR Farnsberg plus;7;Planungsregion Oberbaselbiet;452;7;4;3;51;22;29;0;32;484
1991;2858;Rothenfluh;1304;Bezirk Sissach;9;VR Farnsberg plus;7;Planungsregion Oberbaselbiet;660;12;7;5;62;45;17;0;22;682
1991;2859;Rümlingen;1304;Bezirk Sissach;8;VR Oberes Homburgertal;7;Planungsregion Oberbaselbiet;312;1;2;-1;31;21;10;0;9;321
1991;2860;Rünenberg;1304;Bezirk Sissach;9;VR Farnsberg plus;7;Planungsregion Oberbaselbiet;554;7;9;-2;44;26;18;0;16;570
1991;2861;Sissach;1304;Bezirk Sissach;7;VR Oberbaselbiet;7;Planungsregion Oberbaselbiet;5100;56;44;12;534;387;147;0;159;5259
1991;2862;Tecknau;1304;Bezirk Sissach;7;VR Oberbaselbiet;7;Planungsregion Oberbaselbiet;670;11;5;6;43;34;9;0;15;685
1991;2863;Tenniken;1304;Bezirk Sissach;7;VR Oberbaselbiet;7;Planungsregion Oberbaselbiet;847;11;8;3;52;55;-3;0;0;847
1991;2864;Thürnen;1304;Bezirk Sissach;7;VR Oberbaselbiet;7;Planungsregion Oberbaselbiet;996;11;7;4;128;135;-7;0;-3;993
1991;2865;Wenslingen;1304;Bezirk Sissach;7;VR Oberbaselbiet;7;Planungsregion Oberbaselbiet;618;3;6;-3;39;30;9;0;6;624
1991;2866;Wintersingen;1304;Bezirk Sissach;9;VR Farnsberg plus;7;Planungsregion Oberbaselbiet;509;11;5;6;27;25;2;0;8;517
1991;2867;Wittinsburg;1304;Bezirk Sissach;7;VR Oberbaselbiet;7;Planungsregion Oberbaselbiet;282;3;1;2;17;15;2;0;4;286
1991;2868;Zeglingen;1304;Bezirk Sissach;9;VR Farnsberg plus;7;Planungsregion Oberbaselbiet;459;4;6;-2;48;31;17;0;15;474
1991;2869;Zunzgen;1304;Bezirk Sissach;7;VR Oberbaselbiet;7;Planungsregion Oberbaselbiet;2342;28;8;20;158;152;6;0;26;2368
1991;2881;Arboldswil;1305;Bezirk Waldenburg;10;VR Waldenburgertal plus;8;VR Waldenburgertal plus;414;2;2;0;22;29;-7;0;-7;407
1991;2882;Bennwil;1305;Bezirk Waldenburg;10;VR Waldenburgertal plus;8;VR Waldenburgertal plus;533;6;6;0;15;6;9;0;9;542
1991;2883;Bretzwil;1305;Bezirk Waldenburg;10;VR Waldenburgertal plus;8;VR Waldenburgertal plus;696;15;12;3;36;39;-3;0;0;696
1991;2884;Diegten;1305;Bezirk Waldenburg;7;VR Oberbaselbiet;7;Planungsregion Oberbaselbiet;1130;16;7;9;96;85;11;0;20;1150
1991;2885;Eptingen;1305;Bezirk Waldenburg;7;VR Oberbaselbiet;7;Planungsregion Oberbaselbiet;547;7;5;2;40;44;-4;0;-2;545
1991;2886;Hölstein;1305;Bezirk Waldenburg;10;VR Waldenburgertal plus;8;VR Waldenburgertal plus;1990;25;10;15;180;153;27;0;42;2032
1991;2887;Lampenberg;1305;Bezirk Waldenburg;10;VR Waldenburgertal plus;8;VR Waldenburgertal plus;456;7;5;2;22;25;-3;0;-1;455
1991;2888;Langenbruck;1305;Bezirk Waldenburg;10;VR Waldenburgertal plus;8;VR Waldenburgertal plus;928;17;9;8;105;106;-1;0;7;935
1991;2889;Lauwil;1305;Bezirk Waldenburg;10;VR Waldenburgertal plus;8;VR Waldenburgertal plus;330;3;4;-1;27;30;-3;0;-4;326
1991;2890;Liedertswil;1305;Bezirk Waldenburg;10;VR Waldenburgertal plus;8;VR Waldenburgertal plus;150;3;0;3;2;7;-5;0;-2;148
1991;2891;Niederdorf;1305;Bezirk Waldenburg;10;VR Waldenburgertal plus;8;VR Waldenburgertal plus;1597;17;15;2;124;122;2;0;4;1601
1991;2892;Oberdorf (BL);1305;Bezirk Waldenburg;10;VR Waldenburgertal plus;8;VR Waldenburgertal plus;2022;22;15;7;183;107;76;0;83;2105
1991;2893;Reigoldswil;1305;Bezirk Waldenburg;10;VR Waldenburgertal plus;8;VR Waldenburgertal plus;1376;7;7;0;112;88;24;0;24;1400
1991;2894;Titterten;1305;Bezirk Waldenburg;10;VR Waldenburgertal plus;8;VR Waldenburgertal plus;385;5;3;2;25;21;4;0;6;391
1991;2895;Waldenburg;1305;Bezirk Waldenburg;10;VR Waldenburgertal plus;8;VR Waldenburgertal plus;1254;15;14;1;152;114;38;0;39;1293
1992;2761;Aesch (BL);1301;Bezirk Arlesheim;3;VR Alter Birsstadt;3;VR Alter Birsstadt;9652;122;62;60;648;727;-79;-79;-98;9554
1992;2762;Allschwil;1301;Bezirk Arlesheim;1;VR Alter und Gesundheit ABS;1;VR Alter und Gesundheit ABS;19122;191;152;39;1213;1242;-29;-61;-51;19071
1992;2763;Arlesheim;1301;Bezirk Arlesheim;3;VR Alter Birsstadt;3;VR Alter Birsstadt;8451;63;69;-6;516;570;-54;-92;-152;8299
1992;2764;Biel-Benken;1301;Bezirk Arlesheim;4;VR BPA Leimental;4;VR BPA Leimental;2324;19;9;10;148;125;23;-55;-22;2302
1992;2765;Binningen;1301;Bezirk Arlesheim;1;VR Alter und Gesundheit ABS;1;VR Alter und Gesundheit ABS;14272;155;125;30;1073;1170;-97;-360;-427;13845
1992;2766;Birsfelden;1301;Bezirk Arlesheim;2;VR APG Rheintal;2;VR APG Rheintal;11628;133;95;38;735;817;-82;-182;-226;11402
1992;2767;Bottmingen;1301;Bezirk Arlesheim;4;VR BPA Leimental;4;VR BPA Leimental;5790;52;35;17;599;538;61;-228;-150;5640
1992;2768;Ettingen;1301;Bezirk Arlesheim;4;VR BPA Leimental;4;VR BPA Leimental;4944;55;17;38;215;323;-108;3;-67;4877
1992;2769;Münchenstein;1301;Bezirk Arlesheim;3;VR Alter Birsstadt;3;VR Alter Birsstadt;11650;113;84;29;719;747;-28;181;182;11832
1992;2770;Muttenz;1301;Bezirk Arlesheim;2;VR APG Rheintal;2;VR APG Rheintal;16916;131;148;-17;902;950;-48;262;197;17113
1992;2771;Oberwil (BL);1301;Bezirk Arlesheim;4;VR BPA Leimental;4;VR BPA Leimental;8834;98;59;39;734;706;28;-95;-28;8806
1992;2772;Pfeffingen;1301;Bezirk Arlesheim;3;VR Alter Birsstadt;3;VR Alter Birsstadt;1674;6;11;-5;88;102;-14;14;-5;1669
1992;2773;Reinach (BL);1301;Bezirk Arlesheim;3;VR Alter Birsstadt;3;VR Alter Birsstadt;18305;172;118;54;1045;1157;-112;-114;-172;18133
1992;2774;Schönenbuch;1301;Bezirk Arlesheim;1;VR Alter und Gesundheit ABS;1;VR Alter und Gesundheit ABS;1050;11;5;6;40;68;-28;8;-14;1036
1992;2775;Therwil;1301;Bezirk Arlesheim;4;VR BPA Leimental;4;VR BPA Leimental;7688;51;36;15;536;532;4;11;30;7718
1992;2821;Arisdorf;1303;Bezirk Liestal;6;VR Alters- und Pflegeregion Liestal;6;VR Alters- und Pflegeregion Liestal;1097;11;10;1;81;79;2;6;9;1106
1992;2822;Augst;1303;Bezirk Liestal;2;VR APG Rheintal;2;VR APG Rheintal;797;5;6;-1;100;88;12;-14;-3;794
1992;2823;Bubendorf;1303;Bezirk Liestal;6;VR Alters- und Pflegeregion Liestal;6;VR Alters- und Pflegeregion Liestal;3338;70;24;46;333;329;4;27;77;3415
1992;2824;Frenkendorf;1303;Bezirk Liestal;6;VR Alters- und Pflegeregion Liestal;6;VR Alters- und Pflegeregion Liestal;5664;74;32;42;463;395;68;-11;99;5763
1992;2825;Füllinsdorf;1303;Bezirk Liestal;6;VR Alters- und Pflegeregion Liestal;6;VR Alters- und Pflegeregion Liestal;4005;36;19;17;293;275;18;25;60;4065
1992;2826;Giebenach;1303;Bezirk Liestal;2;VR APG Rheintal;2;VR APG Rheintal;630;10;2;8;62;56;6;25;39;669
1992;2827;Hersberg;1303;Bezirk Liestal;6;VR Alters- und Pflegeregion Liestal;6;VR Alters- und Pflegeregion Liestal;256;0;1;-1;15;11;4;-1;2;258
1992;2828;Lausen;1303;Bezirk Liestal;6;VR Alters- und Pflegeregion Liestal;6;VR Alters- und Pflegeregion Liestal;4386;81;22;59;356;376;-20;10;49;4435
1992;2829;Liestal;1303;Bezirk Liestal;6;VR Alters- und Pflegeregion Liestal;6;VR Alters- und Pflegeregion Liestal;12515;159;103;56;1159;1298;-139;-21;-104;12411
1992;2830;Lupsingen;1303;Bezirk Liestal;6;VR Alters- und Pflegeregion Liestal;6;VR Alters- und Pflegeregion Liestal;1001;9;10;-1;48;58;-10;2;-9;992
1992;2831;Pratteln;1303;Bezirk Liestal;2;VR APG Rheintal;2;VR APG Rheintal;15601;186;124;62;1107;1226;-119;42;-15;15586
1992;2832;Ramlinsburg;1303;Bezirk Liestal;10;VR Waldenburgertal plus;8;VR Waldenburgertal plus;475;7;2;5;42;30;12;-26;-9;466
1992;2833;Seltisberg;1303;Bezirk Liestal;6;VR Alters- und Pflegeregion Liestal;6;VR Alters- und Pflegeregion Liestal;1050;11;8;3;71;66;5;-20;-12;1038
1992;2834;Ziefen;1303;Bezirk Liestal;6;VR Alters- und Pflegeregion Liestal;6;VR Alters- und Pflegeregion Liestal;1146;21;17;4;98;57;41;28;73;1219
1992;2841;Anwil;1304;Bezirk Sissach;9;VR Farnsberg plus;7;Planungsregion Oberbaselbiet;353;6;1;5;39;28;11;-1;15;368
1992;2842;Böckten;1304;Bezirk Sissach;7;VR Oberbaselbiet;7;Planungsregion Oberbaselbiet;731;14;5;9;30;59;-29;-6;-26;705
1992;2843;Buckten;1304;Bezirk Sissach;8;VR Oberes Homburgertal;7;Planungsregion Oberbaselbiet;696;11;4;7;57;65;-8;2;1;697
1992;2844;Buus;1304;Bezirk Sissach;9;VR Farnsberg plus;7;Planungsregion Oberbaselbiet;785;10;9;1;65;60;5;-6;0;785
1992;2845;Diepflingen;1304;Bezirk Sissach;7;VR Oberbaselbiet;7;Planungsregion Oberbaselbiet;419;3;3;0;33;26;7;30;37;456
1992;2846;Gelterkinden;1304;Bezirk Sissach;7;VR Oberbaselbiet;7;Planungsregion Oberbaselbiet;5221;61;51;10;371;328;43;34;87;5308
1992;2847;Häfelfingen;1304;Bezirk Sissach;8;VR Oberes Homburgertal;7;Planungsregion Oberbaselbiet;250;5;3;2;29;27;2;3;7;257
1992;2848;Hemmiken;1304;Bezirk Sissach;9;VR Farnsberg plus;7;Planungsregion Oberbaselbiet;276;5;4;1;21;26;-5;7;3;279
1992;2849;Itingen;1304;Bezirk Sissach;7;VR Oberbaselbiet;7;Planungsregion Oberbaselbiet;1440;19;15;4;94;115;-21;22;5;1445
1992;2850;Känerkinden;1304;Bezirk Sissach;8;VR Oberes Homburgertal;7;Planungsregion Oberbaselbiet;414;5;4;1;29;30;-1;8;8;422
1992;2851;Kilchberg (BL);1304;Bezirk Sissach;9;VR Farnsberg plus;7;Planungsregion Oberbaselbiet;102;0;2;-2;3;2;1;1;0;102
1992;2852;Läufelfingen;1304;Bezirk Sissach;8;VR Oberes Homburgertal;7;Planungsregion Oberbaselbiet;1222;9;14;-5;94;106;-12;26;9;1231
1992;2853;Maisprach;1304;Bezirk Sissach;9;VR Farnsberg plus;7;Planungsregion Oberbaselbiet;705;15;6;9;79;47;32;-10;31;736
1992;2854;Nusshof;1304;Bezirk Sissach;7;VR Oberbaselbiet;7;Planungsregion Oberbaselbiet;181;3;1;2;11;2;9;-4;7;188
1992;2855;Oltingen;1304;Bezirk Sissach;9;VR Farnsberg plus;7;Planungsregion Oberbaselbiet;366;6;2;4;15;27;-12;-1;-9;357
1992;2856;Ormalingen;1304;Bezirk Sissach;7;VR Oberbaselbiet;7;Planungsregion Oberbaselbiet;1560;20;26;-6;143;104;39;20;53;1613
1992;2857;Rickenbach (BL);1304;Bezirk Sissach;9;VR Farnsberg plus;7;Planungsregion Oberbaselbiet;484;9;6;3;40;34;6;-4;5;489
1992;2858;Rothenfluh;1304;Bezirk Sissach;9;VR Farnsberg plus;7;Planungsregion Oberbaselbiet;682;9;6;3;46;36;10;-21;-8;674
1992;2859;Rümlingen;1304;Bezirk Sissach;8;VR Oberes Homburgertal;7;Planungsregion Oberbaselbiet;321;1;1;0;29;27;2;5;7;328
1992;2860;Rünenberg;1304;Bezirk Sissach;9;VR Farnsberg plus;7;Planungsregion Oberbaselbiet;570;8;6;2;35;32;3;12;17;587
1992;2861;Sissach;1304;Bezirk Sissach;7;VR Oberbaselbiet;7;Planungsregion Oberbaselbiet;5259;48;41;7;455;437;18;-46;-21;5238
1992;2862;Tecknau;1304;Bezirk Sissach;7;VR Oberbaselbiet;7;Planungsregion Oberbaselbiet;685;16;10;6;49;67;-18;-10;-22;663
1992;2863;Tenniken;1304;Bezirk Sissach;7;VR Oberbaselbiet;7;Planungsregion Oberbaselbiet;847;15;11;4;39;59;-20;7;-9;838
1992;2864;Thürnen;1304;Bezirk Sissach;7;VR Oberbaselbiet;7;Planungsregion Oberbaselbiet;993;17;4;13;92;128;-36;34;11;1004
1992;2865;Wenslingen;1304;Bezirk Sissach;7;VR Oberbaselbiet;7;Planungsregion Oberbaselbiet;624;3;3;0;36;16;20;-1;19;643
1992;2866;Wintersingen;1304;Bezirk Sissach;9;VR Farnsberg plus;7;Planungsregion Oberbaselbiet;517;5;4;1;24;20;4;0;5;522
1992;2867;Wittinsburg;1304;Bezirk Sissach;7;VR Oberbaselbiet;7;Planungsregion Oberbaselbiet;286;1;1;0;21;16;5;-5;0;286
1992;2868;Zeglingen;1304;Bezirk Sissach;9;VR Farnsberg plus;7;Planungsregion Oberbaselbiet;474;5;6;-1;20;28;-8;-1;-10;464
1992;2869;Zunzgen;1304;Bezirk Sissach;7;VR Oberbaselbiet;7;Planungsregion Oberbaselbiet;2368;28;13;15;150;127;23;39;77;2445
1992;2881;Arboldswil;1305;Bezirk Waldenburg;10;VR Waldenburgertal plus;8;VR Waldenburgertal plus;407;2;7;-5;19;13;6;8;9;416
1992;2882;Bennwil;1305;Bezirk Waldenburg;10;VR Waldenburgertal plus;8;VR Waldenburgertal plus;542;7;9;-2;26;39;-13;30;15;557
1992;2883;Bretzwil;1305;Bezirk Waldenburg;10;VR Waldenburgertal plus;8;VR Waldenburgertal plus;696;8;7;1;20;41;-21;-6;-26;670
1992;2884;Diegten;1305;Bezirk Waldenburg;7;VR Oberbaselbiet;7;Planungsregion Oberbaselbiet;1150;14;4;10;89;102;-13;-16;-19;1131
1992;2885;Eptingen;1305;Bezirk Waldenburg;7;VR Oberbaselbiet;7;Planungsregion Oberbaselbiet;545;4;6;-2;64;43;21;-9;10;555
1992;2886;Hölstein;1305;Bezirk Waldenburg;10;VR Waldenburgertal plus;8;VR Waldenburgertal plus;2032;28;13;15;192;129;63;-41;37;2069
1992;2887;Lampenberg;1305;Bezirk Waldenburg;10;VR Waldenburgertal plus;8;VR Waldenburgertal plus;455;2;1;1;22;12;10;4;15;470
1992;2888;Langenbruck;1305;Bezirk Waldenburg;10;VR Waldenburgertal plus;8;VR Waldenburgertal plus;935;16;5;11;90;96;-6;4;9;944
1992;2889;Lauwil;1305;Bezirk Waldenburg;10;VR Waldenburgertal plus;8;VR Waldenburgertal plus;326;4;6;-2;16;12;4;-18;-16;310
1992;2890;Liedertswil;1305;Bezirk Waldenburg;10;VR Waldenburgertal plus;8;VR Waldenburgertal plus;148;1;1;0;7;7;0;-1;-1;147
1992;2891;Niederdorf;1305;Bezirk Waldenburg;10;VR Waldenburgertal plus;8;VR Waldenburgertal plus;1601;17;6;11;119;109;10;-5;16;1617
1992;2892;Oberdorf (BL);1305;Bezirk Waldenburg;10;VR Waldenburgertal plus;8;VR Waldenburgertal plus;2105;27;30;-3;151;126;25;-5;17;2122
1992;2893;Reigoldswil;1305;Bezirk Waldenburg;10;VR Waldenburgertal plus;8;VR Waldenburgertal plus;1400;18;6;12;99;87;12;-1;23;1423
1992;2894;Titterten;1305;Bezirk Waldenburg;10;VR Waldenburgertal plus;8;VR Waldenburgertal plus;391;0;2;-2;17;27;-10;-16;-28;363
1992;2895;Waldenburg;1305;Bezirk Waldenburg;10;VR Waldenburgertal plus;8;VR Waldenburgertal plus;1293;11;11;0;150;127;23;-19;4;1297
1993;2761;Aesch (BL);1301;Bezirk Arlesheim;3;VR Alter Birsstadt;3;VR Alter Birsstadt;9554;122;67;55;717;752;-35;1;21;9575
1993;2762;Allschwil;1301;Bezirk Arlesheim;1;VR Alter und Gesundheit ABS;1;VR Alter und Gesundheit ABS;19071;183;170;13;1244;1355;-111;0;-98;18973
1993;2763;Arlesheim;1301;Bezirk Arlesheim;3;VR Alter Birsstadt;3;VR Alter Birsstadt;8299;64;79;-15;561;538;23;0;8;8307
1993;2764;Biel-Benken;1301;Bezirk Arlesheim;4;VR BPA Leimental;4;VR BPA Leimental;2302;15;8;7;150;108;42;0;49;2351
1993;2765;Binningen;1301;Bezirk Arlesheim;1;VR Alter und Gesundheit ABS;1;VR Alter und Gesundheit ABS;13845;118;121;-3;948;924;24;0;21;13866
1993;2766;Birsfelden;1301;Bezirk Arlesheim;2;VR APG Rheintal;2;VR APG Rheintal;11402;112;95;17;655;693;-38;0;-21;11381
1993;2767;Bottmingen;1301;Bezirk Arlesheim;4;VR BPA Leimental;4;VR BPA Leimental;5640;47;33;14;356;493;-137;0;-123;5517
1993;2768;Ettingen;1301;Bezirk Arlesheim;4;VR BPA Leimental;4;VR BPA Leimental;4877;47;19;28;372;323;49;0;77;4954
1993;2769;Münchenstein;1301;Bezirk Arlesheim;3;VR Alter Birsstadt;3;VR Alter Birsstadt;11832;107;101;6;749;763;-14;0;-8;11824
1993;2770;Muttenz;1301;Bezirk Arlesheim;2;VR APG Rheintal;2;VR APG Rheintal;17113;150;140;10;925;936;-11;1;0;17113
1993;2771;Oberwil (BL);1301;Bezirk Arlesheim;4;VR BPA Leimental;4;VR BPA Leimental;8806;109;58;51;677;611;66;0;117;8923
1993;2772;Pfeffingen;1301;Bezirk Arlesheim;3;VR Alter Birsstadt;3;VR Alter Birsstadt;1669;15;10;5;108;96;12;0;17;1686
1993;2773;Reinach (BL);1301;Bezirk Arlesheim;3;VR Alter Birsstadt;3;VR Alter Birsstadt;18133;147;92;55;880;951;-71;0;-16;18117
1993;2774;Schönenbuch;1301;Bezirk Arlesheim;1;VR Alter und Gesundheit ABS;1;VR Alter und Gesundheit ABS;1036;12;11;1;51;34;17;0;18;1054
1993;2775;Therwil;1301;Bezirk Arlesheim;4;VR BPA Leimental;4;VR BPA Leimental;7718;79;38;41;459;515;-56;0;-15;7703
1993;2821;Arisdorf;1303;Bezirk Liestal;6;VR Alters- und Pflegeregion Liestal;6;VR Alters- und Pflegeregion Liestal;1106;7;9;-2;95;81;14;0;12;1118
1993;2822;Augst;1303;Bezirk Liestal;2;VR APG Rheintal;2;VR APG Rheintal;794;7;8;-1;93;72;21;0;20;814
1993;2823;Bubendorf;1303;Bezirk Liestal;6;VR Alters- und Pflegeregion Liestal;6;VR Alters- und Pflegeregion Liestal;3415;40;19;21;348;283;65;0;86;3501
1993;2824;Frenkendorf;1303;Bezirk Liestal;6;VR Alters- und Pflegeregion Liestal;6;VR Alters- und Pflegeregion Liestal;5763;66;28;38;421;439;-18;0;20;5783
1993;2825;Füllinsdorf;1303;Bezirk Liestal;6;VR Alters- und Pflegeregion Liestal;6;VR Alters- und Pflegeregion Liestal;4065;30;17;13;288;290;-2;0;11;4076
1993;2826;Giebenach;1303;Bezirk Liestal;2;VR APG Rheintal;2;VR APG Rheintal;669;6;2;4;40;39;1;0;5;674
1993;2827;Hersberg;1303;Bezirk Liestal;6;VR Alters- und Pflegeregion Liestal;6;VR Alters- und Pflegeregion Liestal;258;2;2;0;18;14;4;0;4;262
1993;2828;Lausen;1303;Bezirk Liestal;6;VR Alters- und Pflegeregion Liestal;6;VR Alters- und Pflegeregion Liestal;4435;55;30;25;303;348;-45;0;-20;4415
1993;2829;Liestal;1303;Bezirk Liestal;6;VR Alters- und Pflegeregion Liestal;6;VR Alters- und Pflegeregion Liestal;12411;132;104;28;1014;972;42;-1;69;12480
1993;2830;Lupsingen;1303;Bezirk Liestal;6;VR Alters- und Pflegeregion Liestal;6;VR Alters- und Pflegeregion Liestal;992;7;4;3;54;49;5;0;8;1000
1993;2831;Pratteln;1303;Bezirk Liestal;2;VR APG Rheintal;2;VR APG Rheintal;15586;169;98;71;1066;1099;-33;0;38;15624
1993;2832;Ramlinsburg;1303;Bezirk Liestal;10;VR Waldenburgertal plus;8;VR Waldenburgertal plus;466;4;1;3;47;44;3;0;6;472
1993;2833;Seltisberg;1303;Bezirk Liestal;6;VR Alters- und Pflegeregion Liestal;6;VR Alters- und Pflegeregion Liestal;1038;11;5;6;80;45;35;0;41;1079
1993;2834;Ziefen;1303;Bezirk Liestal;6;VR Alters- und Pflegeregion Liestal;6;VR Alters- und Pflegeregion Liestal;1219;22;9;13;83;78;5;0;18;1237
1993;2841;Anwil;1304;Bezirk Sissach;9;VR Farnsberg plus;7;Planungsregion Oberbaselbiet;368;6;2;4;30;19;11;0;15;383
1993;2842;Böckten;1304;Bezirk Sissach;7;VR Oberbaselbiet;7;Planungsregion Oberbaselbiet;705;9;4;5;38;42;-4;0;1;706
1993;2843;Buckten;1304;Bezirk Sissach;8;VR Oberes Homburgertal;7;Planungsregion Oberbaselbiet;697;14;8;6;48;37;11;0;17;714
1993;2844;Buus;1304;Bezirk Sissach;9;VR Farnsberg plus;7;Planungsregion Oberbaselbiet;785;13;7;6;51;44;7;0;13;798
1993;2845;Diepflingen;1304;Bezirk Sissach;7;VR Oberbaselbiet;7;Planungsregion Oberbaselbiet;456;3;5;-2;49;43;6;0;4;460
1993;2846;Gelterkinden;1304;Bezirk Sissach;7;VR Oberbaselbiet;7;Planungsregion Oberbaselbiet;5308;60;55;5;431;341;90;0;95;5403
1993;2847;Häfelfingen;1304;Bezirk Sissach;8;VR Oberes Homburgertal;7;Planungsregion Oberbaselbiet;257;4;6;-2;22;18;4;0;2;259
1993;2848;Hemmiken;1304;Bezirk Sissach;9;VR Farnsberg plus;7;Planungsregion Oberbaselbiet;279;3;2;1;19;27;-8;0;-7;272
1993;2849;Itingen;1304;Bezirk Sissach;7;VR Oberbaselbiet;7;Planungsregion Oberbaselbiet;1445;15;10;5;122;129;-7;0;-2;1443
1993;2850;Känerkinden;1304;Bezirk Sissach;8;VR Oberes Homburgertal;7;Planungsregion Oberbaselbiet;422;1;1;0;52;26;26;0;26;448
1993;2851;Kilchberg (BL);1304;Bezirk Sissach;9;VR Farnsberg plus;7;Planungsregion Oberbaselbiet;102;1;4;-3;4;5;-1;0;-4;98
1993;2852;Läufelfingen;1304;Bezirk Sissach;8;VR Oberes Homburgertal;7;Planungsregion Oberbaselbiet;1231;12;12;0;108;90;18;1;19;1250
1993;2853;Maisprach;1304;Bezirk Sissach;9;VR Farnsberg plus;7;Planungsregion Oberbaselbiet;736;12;5;7;70;36;34;0;41;777
1993;2854;Nusshof;1304;Bezirk Sissach;7;VR Oberbaselbiet;7;Planungsregion Oberbaselbiet;188;0;4;-4;4;15;-11;0;-15;173
1993;2855;Oltingen;1304;Bezirk Sissach;9;VR Farnsberg plus;7;Planungsregion Oberbaselbiet;357;4;1;3;20;5;15;0;18;375
1993;2856;Ormalingen;1304;Bezirk Sissach;7;VR Oberbaselbiet;7;Planungsregion Oberbaselbiet;1613;20;12;8;134;92;42;0;50;1663
1993;2857;Rickenbach (BL);1304;Bezirk Sissach;9;VR Farnsberg plus;7;Planungsregion Oberbaselbiet;489;0;3;-3;45;31;14;0;11;500
1993;2858;Rothenfluh;1304;Bezirk Sissach;9;VR Farnsberg plus;7;Planungsregion Oberbaselbiet;674;7;4;3;44;42;2;0;5;679
1993;2859;Rümlingen;1304;Bezirk Sissach;8;VR Oberes Homburgertal;7;Planungsregion Oberbaselbiet;328;0;4;-4;21;17;4;0;0;328
1993;2860;Rünenberg;1304;Bezirk Sissach;9;VR Farnsberg plus;7;Planungsregion Oberbaselbiet;587;9;6;3;58;29;29;0;32;619
1993;2861;Sissach;1304;Bezirk Sissach;7;VR Oberbaselbiet;7;Planungsregion Oberbaselbiet;5238;71;51;20;429;375;54;0;74;5312
1993;2862;Tecknau;1304;Bezirk Sissach;7;VR Oberbaselbiet;7;Planungsregion Oberbaselbiet;663;10;6;4;49;40;9;0;13;676
1993;2863;Tenniken;1304;Bezirk Sissach;7;VR Oberbaselbiet;7;Planungsregion Oberbaselbiet;838;9;3;6;54;28;26;0;32;870
1993;2864;Thürnen;1304;Bezirk Sissach;7;VR Oberbaselbiet;7;Planungsregion Oberbaselbiet;1004;8;6;2;165;136;29;0;31;1035
1993;2865;Wenslingen;1304;Bezirk Sissach;7;VR Oberbaselbiet;7;Planungsregion Oberbaselbiet;643;1;8;-7;39;41;-2;0;-9;634
1993;2866;Wintersingen;1304;Bezirk Sissach;9;VR Farnsberg plus;7;Planungsregion Oberbaselbiet;522;2;2;0;27;16;11;0;11;533
1993;2867;Wittinsburg;1304;Bezirk Sissach;7;VR Oberbaselbiet;7;Planungsregion Oberbaselbiet;286;5;0;5;15;9;6;-1;10;296
1993;2868;Zeglingen;1304;Bezirk Sissach;9;VR Farnsberg plus;7;Planungsregion Oberbaselbiet;464;7;5;2;27;24;3;0;5;469
1993;2869;Zunzgen;1304;Bezirk Sissach;7;VR Oberbaselbiet;7;Planungsregion Oberbaselbiet;2445;40;7;33;170;145;25;0;58;2503
1993;2881;Arboldswil;1305;Bezirk Waldenburg;10;VR Waldenburgertal plus;8;VR Waldenburgertal plus;416;6;4;2;47;28;19;-1;20;436
1993;2882;Bennwil;1305;Bezirk Waldenburg;10;VR Waldenburgertal plus;8;VR Waldenburgertal plus;557;14;7;7;55;29;26;-25;8;565
1993;2883;Bretzwil;1305;Bezirk Waldenburg;10;VR Waldenburgertal plus;8;VR Waldenburgertal plus;670;7;4;3;38;31;7;0;10;680
1993;2884;Diegten;1305;Bezirk Waldenburg;7;VR Oberbaselbiet;7;Planungsregion Oberbaselbiet;1131;19;6;13;50;78;-28;0;-15;1116
1993;2885;Eptingen;1305;Bezirk Waldenburg;7;VR Oberbaselbiet;7;Planungsregion Oberbaselbiet;555;7;2;5;38;28;10;0;15;570
1993;2886;Hölstein;1305;Bezirk Waldenburg;10;VR Waldenburgertal plus;8;VR Waldenburgertal plus;2069;23;14;9;164;147;17;0;26;2095
1993;2887;Lampenberg;1305;Bezirk Waldenburg;10;VR Waldenburgertal plus;8;VR Waldenburgertal plus;470;1;2;-1;34;22;12;0;11;481
1993;2888;Langenbruck;1305;Bezirk Waldenburg;10;VR Waldenburgertal plus;8;VR Waldenburgertal plus;944;11;9;2;100;76;24;0;26;970
1993;2889;Lauwil;1305;Bezirk Waldenburg;10;VR Waldenburgertal plus;8;VR Waldenburgertal plus;310;3;2;1;36;23;13;0;14;324
1993;2890;Liedertswil;1305;Bezirk Waldenburg;10;VR Waldenburgertal plus;8;VR Waldenburgertal plus;147;0;1;-1;10;9;1;0;0;147
1993;2891;Niederdorf;1305;Bezirk Waldenburg;10;VR Waldenburgertal plus;8;VR Waldenburgertal plus;1617;16;8;8;84;69;15;0;23;1640
1993;2892;Oberdorf (BL);1305;Bezirk Waldenburg;10;VR Waldenburgertal plus;8;VR Waldenburgertal plus;2122;22;17;5;203;179;24;0;29;2151
1993;2893;Reigoldswil;1305;Bezirk Waldenburg;10;VR Waldenburgertal plus;8;VR Waldenburgertal plus;1423;23;14;9;92;78;14;0;23;1446
1993;2894;Titterten;1305;Bezirk Waldenburg;10;VR Waldenburgertal plus;8;VR Waldenburgertal plus;363;4;1;3;35;27;8;0;11;374
1993;2895;Waldenburg;1305;Bezirk Waldenburg;10;VR Waldenburgertal plus;8;VR Waldenburgertal plus;1297;18;15;3;97;96;1;0;4;1301
1994;2761;Aesch (BL);1301;Bezirk Arlesheim;3;VR Alter Birsstadt;3;VR Alter Birsstadt;9575;82;40;42;611;553;58;0;100;9675
1994;2762;Allschwil;1301;Bezirk Arlesheim;1;VR Alter und Gesundheit ABS;1;VR Alter und Gesundheit ABS;18973;169;154;15;1192;1303;-111;1;-95;18878
1994;2763;Arlesheim;1301;Bezirk Arlesheim;3;VR Alter Birsstadt;3;VR Alter Birsstadt;8307;65;77;-12;643;596;47;0;35;8342
1994;2764;Biel-Benken;1301;Bezirk Arlesheim;4;VR BPA Leimental;4;VR BPA Leimental;2351;15;19;-4;137;146;-9;0;-13;2338
1994;2765;Binningen;1301;Bezirk Arlesheim;1;VR Alter und Gesundheit ABS;1;VR Alter und Gesundheit ABS;13866;111;133;-22;1117;1093;24;1;3;13869
1994;2766;Birsfelden;1301;Bezirk Arlesheim;2;VR APG Rheintal;2;VR APG Rheintal;11381;127;99;28;695;757;-62;2;-32;11349
1994;2767;Bottmingen;1301;Bezirk Arlesheim;4;VR BPA Leimental;4;VR BPA Leimental;5517;49;25;24;355;413;-58;0;-34;5483
1994;2768;Ettingen;1301;Bezirk Arlesheim;4;VR BPA Leimental;4;VR BPA Leimental;4954;50;22;28;248;350;-102;0;-74;4880
1994;2769;Münchenstein;1301;Bezirk Arlesheim;3;VR Alter Birsstadt;3;VR Alter Birsstadt;11824;111;107;4;768;803;-35;0;-31;11793
1994;2770;Muttenz;1301;Bezirk Arlesheim;2;VR APG Rheintal;2;VR APG Rheintal;17113;133;102;31;730;805;-75;0;-44;17069
1994;2771;Oberwil (BL);1301;Bezirk Arlesheim;4;VR BPA Leimental;4;VR BPA Leimental;8923;73;52;21;597;666;-69;1;-47;8876
1994;2772;Pfeffingen;1301;Bezirk Arlesheim;3;VR Alter Birsstadt;3;VR Alter Birsstadt;1686;16;2;14;165;115;50;0;64;1750
1994;2773;Reinach (BL);1301;Bezirk Arlesheim;3;VR Alter Birsstadt;3;VR Alter Birsstadt;18117;144;90;54;1004;1168;-164;1;-109;18008
1994;2774;Schönenbuch;1301;Bezirk Arlesheim;1;VR Alter und Gesundheit ABS;1;VR Alter und Gesundheit ABS;1054;3;1;2;76;80;-4;0;-2;1052
1994;2775;Therwil;1301;Bezirk Arlesheim;4;VR BPA Leimental;4;VR BPA Leimental;7703;65;42;23;471;536;-65;0;-42;7661
1994;2781;Blauen;1302;Bezirk Laufen;5;VR APG Laufental;5;VR APG Laufental;579;9;7;2;46;23;23;0;25;604
1994;2782;Brislach;1302;Bezirk Laufen;5;VR APG Laufental;5;VR APG Laufental;1096;11;4;7;105;61;44;0;51;1147
1994;2783;Burg im Leimental;1302;Bezirk Laufen;4;VR BPA Leimental;4;VR BPA Leimental;212;3;0;3;17;18;-1;0;2;214
1994;2784;Dittingen;1302;Bezirk Laufen;5;VR APG Laufental;5;VR APG Laufental;660;9;6;3;79;62;17;0;20;680
1994;2785;Duggingen;1302;Bezirk Laufen;3;VR Alter Birsstadt;3;VR Alter Birsstadt;958;11;5;6;91;88;3;0;9;967
1994;2786;Grellingen;1302;Bezirk Laufen;5;VR APG Laufental;5;VR APG Laufental;1562;20;6;14;87;85;2;2;18;1580
1994;2787;Laufen;1302;Bezirk Laufen;5;VR APG Laufental;5;VR APG Laufental;4708;60;40;20;394;367;27;-1;46;4754
1994;2788;Liesberg;1302;Bezirk Laufen;5;VR APG Laufental;5;VR APG Laufental;1117;9;11;-2;80;78;2;0;0;1117
1994;2789;Nenzlingen;1302;Bezirk Laufen;5;VR APG Laufental;5;VR APG Laufental;325;3;2;1;67;31;36;0;37;362
1994;2790;Roggenburg;1302;Bezirk Laufen;5;VR APG Laufental;5;VR APG Laufental;212;2;0;2;25;14;11;0;13;225
1994;2791;Röschenz;1302;Bezirk Laufen;5;VR APG Laufental;5;VR APG Laufental;1353;8;11;-3;132;63;69;0;66;1419
1994;2792;Wahlen;1302;Bezirk Laufen;5;VR APG Laufental;5;VR APG Laufental;974;10;9;1;113;68;45;0;46;1020
1994;2793;Zwingen;1302;Bezirk Laufen;5;VR APG Laufental;5;VR APG Laufental;1750;29;10;19;351;178;173;0;192;1942
1994;2821;Arisdorf;1303;Bezirk Liestal;6;VR Alters- und Pflegeregion Liestal;6;VR Alters- und Pflegeregion Liestal;1118;12;8;4;73;48;25;0;29;1147
1994;2822;Augst;1303;Bezirk Liestal;2;VR APG Rheintal;2;VR APG Rheintal;814;7;6;1;99;87;12;0;13;827
1994;2823;Bubendorf;1303;Bezirk Liestal;6;VR Alters- und Pflegeregion Liestal;6;VR Alters- und Pflegeregion Liestal;3501;45;18;27;381;261;120;0;147;3648
1994;2824;Frenkendorf;1303;Bezirk Liestal;6;VR Alters- und Pflegeregion Liestal;6;VR Alters- und Pflegeregion Liestal;5783;64;34;30;463;513;-50;0;-20;5763
1994;2825;Füllinsdorf;1303;Bezirk Liestal;6;VR Alters- und Pflegeregion Liestal;6;VR Alters- und Pflegeregion Liestal;4076;34;24;10;276;331;-55;1;-44;4032
1994;2826;Giebenach;1303;Bezirk Liestal;2;VR APG Rheintal;2;VR APG Rheintal;674;9;3;6;89;69;20;0;26;700
1994;2827;Hersberg;1303;Bezirk Liestal;6;VR Alters- und Pflegeregion Liestal;6;VR Alters- und Pflegeregion Liestal;262;1;2;-1;21;12;9;0;8;270
1994;2828;Lausen;1303;Bezirk Liestal;6;VR Alters- und Pflegeregion Liestal;6;VR Alters- und Pflegeregion Liestal;4415;53;26;27;363;330;33;0;60;4475
1994;2829;Liestal;1303;Bezirk Liestal;6;VR Alters- und Pflegeregion Liestal;6;VR Alters- und Pflegeregion Liestal;12480;132;119;13;1238;1156;82;1;96;12576
1994;2830;Lupsingen;1303;Bezirk Liestal;6;VR Alters- und Pflegeregion Liestal;6;VR Alters- und Pflegeregion Liestal;1000;4;5;-1;56;47;9;0;8;1008
1994;2831;Pratteln;1303;Bezirk Liestal;2;VR APG Rheintal;2;VR APG Rheintal;15624;158;110;48;1030;1176;-146;1;-97;15527
1994;2832;Ramlinsburg;1303;Bezirk Liestal;10;VR Waldenburgertal plus;8;VR Waldenburgertal plus;472;4;3;1;45;25;20;0;21;493
1994;2833;Seltisberg;1303;Bezirk Liestal;6;VR Alters- und Pflegeregion Liestal;6;VR Alters- und Pflegeregion Liestal;1079;10;5;5;104;65;39;0;44;1123
1994;2834;Ziefen;1303;Bezirk Liestal;6;VR Alters- und Pflegeregion Liestal;6;VR Alters- und Pflegeregion Liestal;1237;21;13;8;87;80;7;0;15;1252
1994;2841;Anwil;1304;Bezirk Sissach;9;VR Farnsberg plus;7;Planungsregion Oberbaselbiet;383;9;0;9;44;19;25;0;34;417
1994;2842;Böckten;1304;Bezirk Sissach;7;VR Oberbaselbiet;7;Planungsregion Oberbaselbiet;706;4;6;-2;34;61;-27;0;-29;677
1994;2843;Buckten;1304;Bezirk Sissach;8;VR Oberes Homburgertal;7;Planungsregion Oberbaselbiet;714;5;6;-1;35;64;-29;0;-30;684
1994;2844;Buus;1304;Bezirk Sissach;9;VR Farnsberg plus;7;Planungsregion Oberbaselbiet;798;8;10;-2;61;49;12;0;10;808
1994;2845;Diepflingen;1304;Bezirk Sissach;7;VR Oberbaselbiet;7;Planungsregion Oberbaselbiet;460;3;6;-3;39;46;-7;0;-10;450
1994;2846;Gelterkinden;1304;Bezirk Sissach;7;VR Oberbaselbiet;7;Planungsregion Oberbaselbiet;5403;53;36;17;392;355;37;1;55;5458
1994;2847;Häfelfingen;1304;Bezirk Sissach;8;VR Oberes Homburgertal;7;Planungsregion Oberbaselbiet;259;11;0;11;7;16;-9;0;2;261
1994;2848;Hemmiken;1304;Bezirk Sissach;9;VR Farnsberg plus;7;Planungsregion Oberbaselbiet;272;3;4;-1;15;13;2;0;1;273
1994;2849;Itingen;1304;Bezirk Sissach;7;VR Oberbaselbiet;7;Planungsregion Oberbaselbiet;1443;13;12;1;179;117;62;0;63;1506
1994;2850;Känerkinden;1304;Bezirk Sissach;8;VR Oberes Homburgertal;7;Planungsregion Oberbaselbiet;448;6;6;0;44;26;18;0;18;466
1994;2851;Kilchberg (BL);1304;Bezirk Sissach;9;VR Farnsberg plus;7;Planungsregion Oberbaselbiet;98;0;0;0;0;2;-2;0;-2;96
1994;2852;Läufelfingen;1304;Bezirk Sissach;8;VR Oberes Homburgertal;7;Planungsregion Oberbaselbiet;1250;13;6;7;78;87;-9;0;-2;1248
1994;2853;Maisprach;1304;Bezirk Sissach;9;VR Farnsberg plus;7;Planungsregion Oberbaselbiet;777;8;9;-1;53;47;6;0;5;782
1994;2854;Nusshof;1304;Bezirk Sissach;7;VR Oberbaselbiet;7;Planungsregion Oberbaselbiet;173;1;0;1;10;9;1;0;2;175
1994;2855;Oltingen;1304;Bezirk Sissach;9;VR Farnsberg plus;7;Planungsregion Oberbaselbiet;375;7;8;-1;19;19;0;0;-1;374
1994;2856;Ormalingen;1304;Bezirk Sissach;7;VR Oberbaselbiet;7;Planungsregion Oberbaselbiet;1663;22;13;9;155;126;29;0;38;1701
1994;2857;Rickenbach (BL);1304;Bezirk Sissach;9;VR Farnsberg plus;7;Planungsregion Oberbaselbiet;500;6;1;5;41;43;-2;0;3;503
1994;2858;Rothenfluh;1304;Bezirk Sissach;9;VR Farnsberg plus;7;Planungsregion Oberbaselbiet;679;14;4;10;37;52;-15;0;-5;674
1994;2859;Rümlingen;1304;Bezirk Sissach;8;VR Oberes Homburgertal;7;Planungsregion Oberbaselbiet;328;0;0;0;21;24;-3;0;-3;325
1994;2860;Rünenberg;1304;Bezirk Sissach;9;VR Farnsberg plus;7;Planungsregion Oberbaselbiet;619;12;9;3;58;45;13;0;16;635
1994;2861;Sissach;1304;Bezirk Sissach;7;VR Oberbaselbiet;7;Planungsregion Oberbaselbiet;5312;50;43;7;406;462;-56;0;-49;5263
1994;2862;Tecknau;1304;Bezirk Sissach;7;VR Oberbaselbiet;7;Planungsregion Oberbaselbiet;676;10;9;1;89;71;18;1;20;696
1994;2863;Tenniken;1304;Bezirk Sissach;7;VR Oberbaselbiet;7;Planungsregion Oberbaselbiet;870;6;5;1;75;43;32;1;34;904
1994;2864;Thürnen;1304;Bezirk Sissach;7;VR Oberbaselbiet;7;Planungsregion Oberbaselbiet;1035;9;10;-1;98;96;2;0;1;1036
1994;2865;Wenslingen;1304;Bezirk Sissach;7;VR Oberbaselbiet;7;Planungsregion Oberbaselbiet;634;5;4;1;43;40;3;0;4;638
1994;2866;Wintersingen;1304;Bezirk Sissach;9;VR Farnsberg plus;7;Planungsregion Oberbaselbiet;533;9;3;6;28;31;-3;0;3;536
1994;2867;Wittinsburg;1304;Bezirk Sissach;7;VR Oberbaselbiet;7;Planungsregion Oberbaselbiet;296;7;2;5;21;20;1;0;6;302
1994;2868;Zeglingen;1304;Bezirk Sissach;9;VR Farnsberg plus;7;Planungsregion Oberbaselbiet;469;3;7;-4;32;30;2;0;-2;467
1994;2869;Zunzgen;1304;Bezirk Sissach;7;VR Oberbaselbiet;7;Planungsregion Oberbaselbiet;2503;35;17;18;142;165;-23;0;-5;2498
1994;2881;Arboldswil;1305;Bezirk Waldenburg;10;VR Waldenburgertal plus;8;VR Waldenburgertal plus;436;6;1;5;32;20;12;0;17;453
1994;2882;Bennwil;1305;Bezirk Waldenburg;10;VR Waldenburgertal plus;8;VR Waldenburgertal plus;565;5;6;-1;26;25;1;0;0;565
1994;2883;Bretzwil;1305;Bezirk Waldenburg;10;VR Waldenburgertal plus;8;VR Waldenburgertal plus;680;8;5;3;29;30;-1;0;2;682
1994;2884;Diegten;1305;Bezirk Waldenburg;7;VR Oberbaselbiet;7;Planungsregion Oberbaselbiet;1116;19;6;13;142;87;55;0;68;1184
1994;2885;Eptingen;1305;Bezirk Waldenburg;7;VR Oberbaselbiet;7;Planungsregion Oberbaselbiet;570;4;2;2;37;48;-11;0;-9;561
1994;2886;Hölstein;1305;Bezirk Waldenburg;10;VR Waldenburgertal plus;8;VR Waldenburgertal plus;2095;29;10;19;167;221;-54;0;-35;2060
1994;2887;Lampenberg;1305;Bezirk Waldenburg;10;VR Waldenburgertal plus;8;VR Waldenburgertal plus;481;8;4;4;12;13;-1;0;3;484
1994;2888;Langenbruck;1305;Bezirk Waldenburg;10;VR Waldenburgertal plus;8;VR Waldenburgertal plus;970;9;11;-2;91;70;21;0;19;989
1994;2889;Lauwil;1305;Bezirk Waldenburg;10;VR Waldenburgertal plus;8;VR Waldenburgertal plus;324;6;1;5;16;17;-1;0;4;328
1994;2890;Liedertswil;1305;Bezirk Waldenburg;10;VR Waldenburgertal plus;8;VR Waldenburgertal plus;147;2;1;1;11;12;-1;0;0;147
1994;2891;Niederdorf;1305;Bezirk Waldenburg;10;VR Waldenburgertal plus;8;VR Waldenburgertal plus;1640;21;7;14;118;90;28;0;42;1682
1994;2892;Oberdorf (BL);1305;Bezirk Waldenburg;10;VR Waldenburgertal plus;8;VR Waldenburgertal plus;2151;22;19;3;152;146;6;0;9;2160
1994;2893;Reigoldswil;1305;Bezirk Waldenburg;10;VR Waldenburgertal plus;8;VR Waldenburgertal plus;1446;20;16;4;77;92;-15;0;-11;1435
1994;2894;Titterten;1305;Bezirk Waldenburg;10;VR Waldenburgertal plus;8;VR Waldenburgertal plus;374;8;4;4;24;26;-2;0;2;376
1994;2895;Waldenburg;1305;Bezirk Waldenburg;10;VR Waldenburgertal plus;8;VR Waldenburgertal plus;1301;17;17;0;171;145;26;0;26;1327
1995;2761;Aesch (BL);1301;Bezirk Arlesheim;3;VR Alter Birsstadt;3;VR Alter Birsstadt;9675;108;72;36;878;907;-29;1;8;9683
1995;2762;Allschwil;1301;Bezirk Arlesheim;1;VR Alter und Gesundheit ABS;1;VR Alter und Gesundheit ABS;18878;166;151;15;1127;1221;-94;4;-75;18803
1995;2763;Arlesheim;1301;Bezirk Arlesheim;3;VR Alter Birsstadt;3;VR Alter Birsstadt;8342;77;83;-6;559;529;30;0;24;8366
1995;2764;Biel-Benken;1301;Bezirk Arlesheim;4;VR BPA Leimental;4;VR BPA Leimental;2338;12;10;2;151;135;16;0;18;2356
1995;2765;Binningen;1301;Bezirk Arlesheim;1;VR Alter und Gesundheit ABS;1;VR Alter und Gesundheit ABS;13869;134;123;11;1186;1104;82;1;94;13963
1995;2766;Birsfelden;1301;Bezirk Arlesheim;2;VR APG Rheintal;2;VR APG Rheintal;11349;94;96;-2;669;793;-124;0;-126;11223
1995;2767;Bottmingen;1301;Bezirk Arlesheim;4;VR BPA Leimental;4;VR BPA Leimental;5483;43;36;7;439;477;-38;1;-30;5453
1995;2768;Ettingen;1301;Bezirk Arlesheim;4;VR BPA Leimental;4;VR BPA Leimental;4880;48;17;31;290;412;-122;0;-91;4789
1995;2769;Münchenstein;1301;Bezirk Arlesheim;3;VR Alter Birsstadt;3;VR Alter Birsstadt;11793;125;116;9;786;893;-107;3;-95;11698
1995;2770;Muttenz;1301;Bezirk Arlesheim;2;VR APG Rheintal;2;VR APG Rheintal;17069;117;147;-30;771;931;-160;1;-189;16880
1995;2771;Oberwil (BL);1301;Bezirk Arlesheim;4;VR BPA Leimental;4;VR BPA Leimental;8876;92;53;39;715;707;8;0;47;8923
1995;2772;Pfeffingen;1301;Bezirk Arlesheim;3;VR Alter Birsstadt;3;VR Alter Birsstadt;1750;9;8;1;217;126;91;0;92;1842
1995;2773;Reinach (BL);1301;Bezirk Arlesheim;3;VR Alter Birsstadt;3;VR Alter Birsstadt;18008;157;98;59;1230;1255;-25;3;37;18045
1995;2774;Schönenbuch;1301;Bezirk Arlesheim;1;VR Alter und Gesundheit ABS;1;VR Alter und Gesundheit ABS;1052;10;3;7;64;43;21;0;28;1080
1995;2775;Therwil;1301;Bezirk Arlesheim;4;VR BPA Leimental;4;VR BPA Leimental;7661;81;45;36;553;595;-42;0;-6;7655
1995;2781;Blauen;1302;Bezirk Laufen;5;VR APG Laufental;5;VR APG Laufental;604;6;5;1;36;28;8;0;9;613
1995;2782;Brislach;1302;Bezirk Laufen;5;VR APG Laufental;5;VR APG Laufental;1147;14;7;7;156;62;94;0;101;1248
1995;2783;Burg im Leimental;1302;Bezirk Laufen;4;VR BPA Leimental;4;VR BPA Leimental;214;1;2;-1;24;22;2;0;1;215
1995;2784;Dittingen;1302;Bezirk Laufen;5;VR APG Laufental;5;VR APG Laufental;680;13;4;9;70;44;26;0;35;715
1995;2785;Duggingen;1302;Bezirk Laufen;3;VR Alter Birsstadt;3;VR Alter Birsstadt;967;8;5;3;112;79;33;0;36;1003
1995;2786;Grellingen;1302;Bezirk Laufen;5;VR APG Laufental;5;VR APG Laufental;1580;24;13;11;162;117;45;0;56;1636
1995;2787;Laufen;1302;Bezirk Laufen;5;VR APG Laufental;5;VR APG Laufental;4754;46;30;16;333;388;-55;1;-38;4716
1995;2788;Liesberg;1302;Bezirk Laufen;5;VR APG Laufental;5;VR APG Laufental;1117;11;8;3;107;56;51;0;54;1171
1995;2789;Nenzlingen;1302;Bezirk Laufen;5;VR APG Laufental;5;VR APG Laufental;362;4;6;-2;28;26;2;-9;-9;353
1995;2790;Roggenburg;1302;Bezirk Laufen;5;VR APG Laufental;5;VR APG Laufental;225;3;1;2;26;22;4;0;6;231
1995;2791;Röschenz;1302;Bezirk Laufen;5;VR APG Laufental;5;VR APG Laufental;1419;16;15;1;131;68;63;0;64;1483
1995;2792;Wahlen;1302;Bezirk Laufen;5;VR APG Laufental;5;VR APG Laufental;1020;8;7;1;135;79;56;0;57;1077
1995;2793;Zwingen;1302;Bezirk Laufen;5;VR APG Laufental;5;VR APG Laufental;1942;22;14;8;237;214;23;0;31;1973
1995;2821;Arisdorf;1303;Bezirk Liestal;6;VR Alters- und Pflegeregion Liestal;6;VR Alters- und Pflegeregion Liestal;1147;15;7;8;77;57;20;0;28;1175
1995;2822;Augst;1303;Bezirk Liestal;2;VR APG Rheintal;2;VR APG Rheintal;827;6;6;0;71;106;-35;0;-35;792
1995;2823;Bubendorf;1303;Bezirk Liestal;6;VR Alters- und Pflegeregion Liestal;6;VR Alters- und Pflegeregion Liestal;3648;45;16;29;491;309;182;0;211;3859
1995;2824;Frenkendorf;1303;Bezirk Liestal;6;VR Alters- und Pflegeregion Liestal;6;VR Alters- und Pflegeregion Liestal;5763;61;35;26;466;526;-60;0;-34;5729
1995;2825;Füllinsdorf;1303;Bezirk Liestal;6;VR Alters- und Pflegeregion Liestal;6;VR Alters- und Pflegeregion Liestal;4032;39;21;18;385;365;20;0;38;4070
1995;2826;Giebenach;1303;Bezirk Liestal;2;VR APG Rheintal;2;VR APG Rheintal;700;7;2;5;55;58;-3;2;4;704
1995;2827;Hersberg;1303;Bezirk Liestal;6;VR Alters- und Pflegeregion Liestal;6;VR Alters- und Pflegeregion Liestal;270;1;1;0;3;1;2;0;2;272
1995;2828;Lausen;1303;Bezirk Liestal;6;VR Alters- und Pflegeregion Liestal;6;VR Alters- und Pflegeregion Liestal;4475;55;31;24;362;352;10;0;34;4509
1995;2829;Liestal;1303;Bezirk Liestal;6;VR Alters- und Pflegeregion Liestal;6;VR Alters- und Pflegeregion Liestal;12576;158;85;73;953;1043;-90;3;-14;12562
1995;2830;Lupsingen;1303;Bezirk Liestal;6;VR Alters- und Pflegeregion Liestal;6;VR Alters- und Pflegeregion Liestal;1008;6;5;1;61;43;18;0;19;1027
1995;2831;Pratteln;1303;Bezirk Liestal;2;VR APG Rheintal;2;VR APG Rheintal;15527;147;120;27;1021;1107;-86;2;-57;15470
1995;2832;Ramlinsburg;1303;Bezirk Liestal;10;VR Waldenburgertal plus;8;VR Waldenburgertal plus;493;8;1;7;42;48;-6;0;1;494
1995;2833;Seltisberg;1303;Bezirk Liestal;6;VR Alters- und Pflegeregion Liestal;6;VR Alters- und Pflegeregion Liestal;1123;9;8;1;109;79;30;0;31;1154
1995;2834;Ziefen;1303;Bezirk Liestal;6;VR Alters- und Pflegeregion Liestal;6;VR Alters- und Pflegeregion Liestal;1252;20;13;7;114;90;24;0;31;1283
1995;2841;Anwil;1304;Bezirk Sissach;9;VR Farnsberg plus;7;Planungsregion Oberbaselbiet;417;6;1;5;35;13;22;0;27;444
1995;2842;Böckten;1304;Bezirk Sissach;7;VR Oberbaselbiet;7;Planungsregion Oberbaselbiet;677;13;8;5;45;41;4;0;9;686
1995;2843;Buckten;1304;Bezirk Sissach;8;VR Oberes Homburgertal;7;Planungsregion Oberbaselbiet;684;7;3;4;44;41;3;0;7;691
1995;2844;Buus;1304;Bezirk Sissach;9;VR Farnsberg plus;7;Planungsregion Oberbaselbiet;808;9;4;5;57;43;14;0;19;827
1995;2845;Diepflingen;1304;Bezirk Sissach;7;VR Oberbaselbiet;7;Planungsregion Oberbaselbiet;450;3;3;0;30;21;9;0;9;459
1995;2846;Gelterkinden;1304;Bezirk Sissach;7;VR Oberbaselbiet;7;Planungsregion Oberbaselbiet;5458;58;45;13;321;392;-71;0;-58;5400
1995;2847;Häfelfingen;1304;Bezirk Sissach;8;VR Oberes Homburgertal;7;Planungsregion Oberbaselbiet;261;3;2;1;15;9;6;-13;-6;255
1995;2848;Hemmiken;1304;Bezirk Sissach;9;VR Farnsberg plus;7;Planungsregion Oberbaselbiet;273;4;2;2;11;10;1;0;3;276
1995;2849;Itingen;1304;Bezirk Sissach;7;VR Oberbaselbiet;7;Planungsregion Oberbaselbiet;1506;16;6;10;174;119;55;0;65;1571
1995;2850;Känerkinden;1304;Bezirk Sissach;8;VR Oberes Homburgertal;7;Planungsregion Oberbaselbiet;466;3;6;-3;33;28;5;0;2;468
1995;2851;Kilchberg (BL);1304;Bezirk Sissach;9;VR Farnsberg plus;7;Planungsregion Oberbaselbiet;96;0;0;0;8;5;3;0;3;99
1995;2852;Läufelfingen;1304;Bezirk Sissach;8;VR Oberes Homburgertal;7;Planungsregion Oberbaselbiet;1248;12;12;0;104;61;43;0;43;1291
1995;2853;Maisprach;1304;Bezirk Sissach;9;VR Farnsberg plus;7;Planungsregion Oberbaselbiet;782;8;5;3;68;57;11;0;14;796
1995;2854;Nusshof;1304;Bezirk Sissach;7;VR Oberbaselbiet;7;Planungsregion Oberbaselbiet;175;1;2;-1;10;8;2;0;1;176
1995;2855;Oltingen;1304;Bezirk Sissach;9;VR Farnsberg plus;7;Planungsregion Oberbaselbiet;374;4;2;2;31;9;22;0;24;398
1995;2856;Ormalingen;1304;Bezirk Sissach;7;VR Oberbaselbiet;7;Planungsregion Oberbaselbiet;1701;17;15;2;176;95;81;0;83;1784
1995;2857;Rickenbach (BL);1304;Bezirk Sissach;9;VR Farnsberg plus;7;Planungsregion Oberbaselbiet;503;5;4;1;41;25;16;0;17;520
1995;2858;Rothenfluh;1304;Bezirk Sissach;9;VR Farnsberg plus;7;Planungsregion Oberbaselbiet;674;9;7;2;39;40;-1;0;1;675
1995;2859;Rümlingen;1304;Bezirk Sissach;8;VR Oberes Homburgertal;7;Planungsregion Oberbaselbiet;325;4;2;2;29;39;-10;0;-8;317
1995;2860;Rünenberg;1304;Bezirk Sissach;9;VR Farnsberg plus;7;Planungsregion Oberbaselbiet;635;13;5;8;40;26;14;0;22;657
1995;2861;Sissach;1304;Bezirk Sissach;7;VR Oberbaselbiet;7;Planungsregion Oberbaselbiet;5263;50;44;6;487;466;21;1;28;5291
1995;2862;Tecknau;1304;Bezirk Sissach;7;VR Oberbaselbiet;7;Planungsregion Oberbaselbiet;696;11;4;7;121;67;54;0;61;757
1995;2863;Tenniken;1304;Bezirk Sissach;7;VR Oberbaselbiet;7;Planungsregion Oberbaselbiet;904;6;7;-1;57;62;-5;0;-6;898
1995;2864;Thürnen;1304;Bezirk Sissach;7;VR Oberbaselbiet;7;Planungsregion Oberbaselbiet;1036;10;5;5;97;95;2;1;8;1044
1995;2865;Wenslingen;1304;Bezirk Sissach;7;VR Oberbaselbiet;7;Planungsregion Oberbaselbiet;638;6;8;-2;17;24;-7;0;-9;629
1995;2866;Wintersingen;1304;Bezirk Sissach;9;VR Farnsberg plus;7;Planungsregion Oberbaselbiet;536;5;4;1;42;31;11;0;12;548
1995;2867;Wittinsburg;1304;Bezirk Sissach;7;VR Oberbaselbiet;7;Planungsregion Oberbaselbiet;302;5;3;2;19;21;-2;0;0;302
1995;2868;Zeglingen;1304;Bezirk Sissach;9;VR Farnsberg plus;7;Planungsregion Oberbaselbiet;467;6;4;2;28;29;-1;0;1;468
1995;2869;Zunzgen;1304;Bezirk Sissach;7;VR Oberbaselbiet;7;Planungsregion Oberbaselbiet;2498;42;9;33;167;154;13;0;46;2544
1995;2881;Arboldswil;1305;Bezirk Waldenburg;10;VR Waldenburgertal plus;8;VR Waldenburgertal plus;453;6;4;2;32;22;10;0;12;465
1995;2882;Bennwil;1305;Bezirk Waldenburg;10;VR Waldenburgertal plus;8;VR Waldenburgertal plus;565;7;5;2;51;41;10;-19;-7;558
1995;2883;Bretzwil;1305;Bezirk Waldenburg;10;VR Waldenburgertal plus;8;VR Waldenburgertal plus;682;8;5;3;48;33;15;0;18;700
1995;2884;Diegten;1305;Bezirk Waldenburg;7;VR Oberbaselbiet;7;Planungsregion Oberbaselbiet;1184;16;8;8;95;65;30;0;38;1222
1995;2885;Eptingen;1305;Bezirk Waldenburg;7;VR Oberbaselbiet;7;Planungsregion Oberbaselbiet;561;7;5;2;44;36;8;0;10;571
1995;2886;Hölstein;1305;Bezirk Waldenburg;10;VR Waldenburgertal plus;8;VR Waldenburgertal plus;2060;21;14;7;159;191;-32;0;-25;2035
1995;2887;Lampenberg;1305;Bezirk Waldenburg;10;VR Waldenburgertal plus;8;VR Waldenburgertal plus;484;3;2;1;23;26;-3;0;-2;482
1995;2888;Langenbruck;1305;Bezirk Waldenburg;10;VR Waldenburgertal plus;8;VR Waldenburgertal plus;989;12;4;8;92;82;10;0;18;1007
1995;2889;Lauwil;1305;Bezirk Waldenburg;10;VR Waldenburgertal plus;8;VR Waldenburgertal plus;328;11;6;5;18;22;-4;0;1;329
1995;2890;Liedertswil;1305;Bezirk Waldenburg;10;VR Waldenburgertal plus;8;VR Waldenburgertal plus;147;0;2;-2;22;14;8;0;6;153
1995;2891;Niederdorf;1305;Bezirk Waldenburg;10;VR Waldenburgertal plus;8;VR Waldenburgertal plus;1682;20;17;3;85;154;-69;0;-66;1616
1995;2892;Oberdorf (BL);1305;Bezirk Waldenburg;10;VR Waldenburgertal plus;8;VR Waldenburgertal plus;2160;27;12;15;237;157;80;0;95;2255
1995;2893;Reigoldswil;1305;Bezirk Waldenburg;10;VR Waldenburgertal plus;8;VR Waldenburgertal plus;1435;12;16;-4;94;98;-4;0;-8;1427
1995;2894;Titterten;1305;Bezirk Waldenburg;10;VR Waldenburgertal plus;8;VR Waldenburgertal plus;376;4;4;0;33;23;10;0;10;386
1995;2895;Waldenburg;1305;Bezirk Waldenburg;10;VR Waldenburgertal plus;8;VR Waldenburgertal plus;1327;17;8;9;149;131;18;0;27;1354
1996;2761;Aesch (BL);1301;Bezirk Arlesheim;3;VR Alter Birsstadt;3;VR Alter Birsstadt;9683;95;57;38;1055;762;293;6;337;10020
1996;2762;Allschwil;1301;Bezirk Arlesheim;1;VR Alter und Gesundheit ABS;1;VR Alter und Gesundheit ABS;18803;163;158;5;1186;1197;-11;8;2;18805
1996;2763;Arlesheim;1301;Bezirk Arlesheim;3;VR Alter Birsstadt;3;VR Alter Birsstadt;8366;85;69;16;630;554;76;1;93;8459
1996;2764;Biel-Benken;1301;Bezirk Arlesheim;4;VR BPA Leimental;4;VR BPA Leimental;2356;8;18;-10;204;137;67;1;58;2414
1996;2765;Binningen;1301;Bezirk Arlesheim;1;VR Alter und Gesundheit ABS;1;VR Alter und Gesundheit ABS;13963;118;129;-11;1174;1144;30;2;21;13984
1996;2766;Birsfelden;1301;Bezirk Arlesheim;2;VR APG Rheintal;2;VR APG Rheintal;11223;117;91;26;711;866;-155;0;-129;11094
1996;2767;Bottmingen;1301;Bezirk Arlesheim;4;VR BPA Leimental;4;VR BPA Leimental;5453;35;31;4;522;504;18;5;27;5480
1996;2768;Ettingen;1301;Bezirk Arlesheim;4;VR BPA Leimental;4;VR BPA Leimental;4789;58;22;36;332;358;-26;1;11;4800
1996;2769;Münchenstein;1301;Bezirk Arlesheim;3;VR Alter Birsstadt;3;VR Alter Birsstadt;11698;113;116;-3;902;878;24;1;22;11720
1996;2770;Muttenz;1301;Bezirk Arlesheim;2;VR APG Rheintal;2;VR APG Rheintal;16880;110;115;-5;786;997;-211;1;-215;16665
1996;2771;Oberwil (BL);1301;Bezirk Arlesheim;4;VR BPA Leimental;4;VR BPA Leimental;8923;91;55;36;838;686;152;1;189;9112
1996;2772;Pfeffingen;1301;Bezirk Arlesheim;3;VR Alter Birsstadt;3;VR Alter Birsstadt;1842;11;9;2;125;102;23;0;25;1867
1996;2773;Reinach (BL);1301;Bezirk Arlesheim;3;VR Alter Birsstadt;3;VR Alter Birsstadt;18045;147;140;7;1300;1331;-31;7;-17;18028
1996;2774;Schönenbuch;1301;Bezirk Arlesheim;1;VR Alter und Gesundheit ABS;1;VR Alter und Gesundheit ABS;1080;9;6;3;74;58;16;2;21;1101
1996;2775;Therwil;1301;Bezirk Arlesheim;4;VR BPA Leimental;4;VR BPA Leimental;7655;66;45;21;518;568;-50;0;-29;7626
1996;2781;Blauen;1302;Bezirk Laufen;5;VR APG Laufental;5;VR APG Laufental;613;9;6;3;40;26;14;0;17;630
1996;2782;Brislach;1302;Bezirk Laufen;5;VR APG Laufental;5;VR APG Laufental;1248;20;13;7;118;83;35;0;42;1290
1996;2783;Burg im Leimental;1302;Bezirk Laufen;4;VR BPA Leimental;4;VR BPA Leimental;215;6;1;5;16;11;5;0;10;225
1996;2784;Dittingen;1302;Bezirk Laufen;5;VR APG Laufental;5;VR APG Laufental;715;6;5;1;62;72;-10;1;-8;707
1996;2785;Duggingen;1302;Bezirk Laufen;3;VR Alter Birsstadt;3;VR Alter Birsstadt;1003;8;4;4;90;66;24;0;28;1031
1996;2786;Grellingen;1302;Bezirk Laufen;5;VR APG Laufental;5;VR APG Laufental;1636;19;9;10;94;123;-29;0;-19;1617
1996;2787;Laufen;1302;Bezirk Laufen;5;VR APG Laufental;5;VR APG Laufental;4716;54;38;16;336;302;34;1;51;4767
1996;2788;Liesberg;1302;Bezirk Laufen;5;VR APG Laufental;5;VR APG Laufental;1171;18;12;6;71;68;3;0;9;1180
1996;2789;Nenzlingen;1302;Bezirk Laufen;5;VR APG Laufental;5;VR APG Laufental;353;6;4;2;48;37;11;1;14;367
1996;2790;Roggenburg;1302;Bezirk Laufen;5;VR APG Laufental;5;VR APG Laufental;231;6;0;6;19;13;6;0;12;243
1996;2791;Röschenz;1302;Bezirk Laufen;5;VR APG Laufental;5;VR APG Laufental;1483;13;10;3;121;91;30;0;33;1516
1996;2792;Wahlen;1302;Bezirk Laufen;5;VR APG Laufental;5;VR APG Laufental;1077;17;9;8;77;63;14;0;22;1099
1996;2793;Zwingen;1302;Bezirk Laufen;5;VR APG Laufental;5;VR APG Laufental;1973;28;11;17;203;220;-17;0;0;1973
1996;2821;Arisdorf;1303;Bezirk Liestal;6;VR Alters- und Pflegeregion Liestal;6;VR Alters- und Pflegeregion Liestal;1175;12;9;3;144;72;72;0;75;1250
1996;2822;Augst;1303;Bezirk Liestal;2;VR APG Rheintal;2;VR APG Rheintal;792;11;6;5;90;84;6;0;11;803
1996;2823;Bubendorf;1303;Bezirk Liestal;6;VR Alters- und Pflegeregion Liestal;6;VR Alters- und Pflegeregion Liestal;3859;63;20;43;425;278;147;0;190;4049
1996;2824;Frenkendorf;1303;Bezirk Liestal;6;VR Alters- und Pflegeregion Liestal;6;VR Alters- und Pflegeregion Liestal;5729;67;31;36;647;534;113;4;153;5882
1996;2825;Füllinsdorf;1303;Bezirk Liestal;6;VR Alters- und Pflegeregion Liestal;6;VR Alters- und Pflegeregion Liestal;4070;34;25;9;424;369;55;0;64;4134
1996;2826;Giebenach;1303;Bezirk Liestal;2;VR APG Rheintal;2;VR APG Rheintal;704;14;1;13;120;53;67;0;80;784
1996;2827;Hersberg;1303;Bezirk Liestal;6;VR Alters- und Pflegeregion Liestal;6;VR Alters- und Pflegeregion Liestal;272;1;1;0;6;12;-6;0;-6;266
1996;2828;Lausen;1303;Bezirk Liestal;6;VR Alters- und Pflegeregion Liestal;6;VR Alters- und Pflegeregion Liestal;4509;59;28;31;301;385;-84;1;-52;4457
1996;2829;Liestal;1303;Bezirk Liestal;6;VR Alters- und Pflegeregion Liestal;6;VR Alters- und Pflegeregion Liestal;12562;124;93;31;1138;1210;-72;5;-36;12526
1996;2830;Lupsingen;1303;Bezirk Liestal;6;VR Alters- und Pflegeregion Liestal;6;VR Alters- und Pflegeregion Liestal;1027;10;8;2;96;50;46;1;49;1076
1996;2831;Pratteln;1303;Bezirk Liestal;2;VR APG Rheintal;2;VR APG Rheintal;15470;128;81;47;908;1034;-126;3;-76;15394
1996;2832;Ramlinsburg;1303;Bezirk Liestal;10;VR Waldenburgertal plus;8;VR Waldenburgertal plus;494;6;2;4;60;45;15;0;19;513
1996;2833;Seltisberg;1303;Bezirk Liestal;6;VR Alters- und Pflegeregion Liestal;6;VR Alters- und Pflegeregion Liestal;1154;8;2;6;112;79;33;0;39;1193
1996;2834;Ziefen;1303;Bezirk Liestal;6;VR Alters- und Pflegeregion Liestal;6;VR Alters- und Pflegeregion Liestal;1283;12;22;-10;86;81;5;0;-5;1278
1996;2841;Anwil;1304;Bezirk Sissach;9;VR Farnsberg plus;7;Planungsregion Oberbaselbiet;444;8;2;6;31;32;-1;0;5;449
1996;2842;Böckten;1304;Bezirk Sissach;7;VR Oberbaselbiet;7;Planungsregion Oberbaselbiet;686;12;9;3;41;50;-9;0;-6;680
1996;2843;Buckten;1304;Bezirk Sissach;8;VR Oberes Homburgertal;7;Planungsregion Oberbaselbiet;691;8;7;1;81;70;11;0;12;703
1996;2844;Buus;1304;Bezirk Sissach;9;VR Farnsberg plus;7;Planungsregion Oberbaselbiet;827;7;3;4;60;47;13;1;18;845
1996;2845;Diepflingen;1304;Bezirk Sissach;7;VR Oberbaselbiet;7;Planungsregion Oberbaselbiet;459;6;1;5;46;48;-2;0;3;462
1996;2846;Gelterkinden;1304;Bezirk Sissach;7;VR Oberbaselbiet;7;Planungsregion Oberbaselbiet;5400;61;51;10;384;436;-52;1;-41;5359
1996;2847;Häfelfingen;1304;Bezirk Sissach;8;VR Oberes Homburgertal;7;Planungsregion Oberbaselbiet;255;6;1;5;18;26;-8;0;-3;252
1996;2848;Hemmiken;1304;Bezirk Sissach;9;VR Farnsberg plus;7;Planungsregion Oberbaselbiet;276;3;2;1;13;30;-17;0;-16;260
1996;2849;Itingen;1304;Bezirk Sissach;7;VR Oberbaselbiet;7;Planungsregion Oberbaselbiet;1571;18;11;7;133;124;9;1;17;1588
1996;2850;Känerkinden;1304;Bezirk Sissach;8;VR Oberes Homburgertal;7;Planungsregion Oberbaselbiet;468;3;2;1;43;23;20;0;21;489
1996;2851;Kilchberg (BL);1304;Bezirk Sissach;9;VR Farnsberg plus;7;Planungsregion Oberbaselbiet;99;0;1;-1;11;10;1;0;0;99
1996;2852;Läufelfingen;1304;Bezirk Sissach;8;VR Oberes Homburgertal;7;Planungsregion Oberbaselbiet;1291;12;6;6;64;88;-24;1;-17;1274
1996;2853;Maisprach;1304;Bezirk Sissach;9;VR Farnsberg plus;7;Planungsregion Oberbaselbiet;796;12;9;3;84;74;10;1;14;810
1996;2854;Nusshof;1304;Bezirk Sissach;7;VR Oberbaselbiet;7;Planungsregion Oberbaselbiet;176;2;0;2;6;8;-2;0;0;176
1996;2855;Oltingen;1304;Bezirk Sissach;9;VR Farnsberg plus;7;Planungsregion Oberbaselbiet;398;10;2;8;20;11;9;0;17;415
1996;2856;Ormalingen;1304;Bezirk Sissach;7;VR Oberbaselbiet;7;Planungsregion Oberbaselbiet;1784;20;12;8;124;121;3;0;11;1795
1996;2857;Rickenbach (BL);1304;Bezirk Sissach;9;VR Farnsberg plus;7;Planungsregion Oberbaselbiet;520;7;4;3;32;43;-11;0;-8;512
1996;2858;Rothenfluh;1304;Bezirk Sissach;9;VR Farnsberg plus;7;Planungsregion Oberbaselbiet;675;11;4;7;58;64;-6;0;1;676
1996;2859;Rümlingen;1304;Bezirk Sissach;8;VR Oberes Homburgertal;7;Planungsregion Oberbaselbiet;317;1;1;0;16;14;2;0;2;319
1996;2860;Rünenberg;1304;Bezirk Sissach;9;VR Farnsberg plus;7;Planungsregion Oberbaselbiet;657;7;2;5;43;33;10;0;15;672
1996;2861;Sissach;1304;Bezirk Sissach;7;VR Oberbaselbiet;7;Planungsregion Oberbaselbiet;5291;56;51;5;431;481;-50;1;-44;5247
1996;2862;Tecknau;1304;Bezirk Sissach;7;VR Oberbaselbiet;7;Planungsregion Oberbaselbiet;757;9;3;6;110;83;27;0;33;790
1996;2863;Tenniken;1304;Bezirk Sissach;7;VR Oberbaselbiet;7;Planungsregion Oberbaselbiet;898;6;3;3;69;40;29;0;32;930
1996;2864;Thürnen;1304;Bezirk Sissach;7;VR Oberbaselbiet;7;Planungsregion Oberbaselbiet;1044;13;7;6;68;107;-39;0;-33;1011
1996;2865;Wenslingen;1304;Bezirk Sissach;7;VR Oberbaselbiet;7;Planungsregion Oberbaselbiet;629;5;6;-1;43;29;14;0;13;642
1996;2866;Wintersingen;1304;Bezirk Sissach;9;VR Farnsberg plus;7;Planungsregion Oberbaselbiet;548;6;5;1;47;20;27;0;28;576
1996;2867;Wittinsburg;1304;Bezirk Sissach;7;VR Oberbaselbiet;7;Planungsregion Oberbaselbiet;302;5;2;3;16;12;4;0;7;309
1996;2868;Zeglingen;1304;Bezirk Sissach;9;VR Farnsberg plus;7;Planungsregion Oberbaselbiet;468;8;6;2;41;29;12;0;14;482
1996;2869;Zunzgen;1304;Bezirk Sissach;7;VR Oberbaselbiet;7;Planungsregion Oberbaselbiet;2544;31;15;16;120;154;-34;0;-18;2526
1996;2881;Arboldswil;1305;Bezirk Waldenburg;10;VR Waldenburgertal plus;8;VR Waldenburgertal plus;465;4;2;2;21;9;12;0;14;479
1996;2882;Bennwil;1305;Bezirk Waldenburg;10;VR Waldenburgertal plus;8;VR Waldenburgertal plus;558;6;4;2;32;49;-17;0;-15;543
1996;2883;Bretzwil;1305;Bezirk Waldenburg;10;VR Waldenburgertal plus;8;VR Waldenburgertal plus;700;10;6;4;37;48;-11;0;-7;693
1996;2884;Diegten;1305;Bezirk Waldenburg;7;VR Oberbaselbiet;7;Planungsregion Oberbaselbiet;1222;18;9;9;108;73;35;0;44;1266
1996;2885;Eptingen;1305;Bezirk Waldenburg;7;VR Oberbaselbiet;7;Planungsregion Oberbaselbiet;571;6;7;-1;58;36;22;0;21;592
1996;2886;Hölstein;1305;Bezirk Waldenburg;10;VR Waldenburgertal plus;8;VR Waldenburgertal plus;2035;20;11;9;163;188;-25;1;-15;2020
1996;2887;Lampenberg;1305;Bezirk Waldenburg;10;VR Waldenburgertal plus;8;VR Waldenburgertal plus;482;9;5;4;27;27;0;0;4;486
1996;2888;Langenbruck;1305;Bezirk Waldenburg;10;VR Waldenburgertal plus;8;VR Waldenburgertal plus;1007;13;14;-1;76;99;-23;0;-24;983
1996;2889;Lauwil;1305;Bezirk Waldenburg;10;VR Waldenburgertal plus;8;VR Waldenburgertal plus;329;2;1;1;15;27;-12;0;-11;318
1996;2890;Liedertswil;1305;Bezirk Waldenburg;10;VR Waldenburgertal plus;8;VR Waldenburgertal plus;153;1;0;1;5;6;-1;0;0;153
1996;2891;Niederdorf;1305;Bezirk Waldenburg;10;VR Waldenburgertal plus;8;VR Waldenburgertal plus;1616;19;12;7;126;88;38;1;46;1662
1996;2892;Oberdorf (BL);1305;Bezirk Waldenburg;10;VR Waldenburgertal plus;8;VR Waldenburgertal plus;2255;20;20;0;215;153;62;0;62;2317
1996;2893;Reigoldswil;1305;Bezirk Waldenburg;10;VR Waldenburgertal plus;8;VR Waldenburgertal plus;1427;18;11;7;96;87;9;0;16;1443
1996;2894;Titterten;1305;Bezirk Waldenburg;10;VR Waldenburgertal plus;8;VR Waldenburgertal plus;386;5;2;3;37;28;9;0;12;398
1996;2895;Waldenburg;1305;Bezirk Waldenburg;10;VR Waldenburgertal plus;8;VR Waldenburgertal plus;1354;30;19;11;165;121;44;0;55;1409
1997;2761;Aesch (BL);1301;Bezirk Arlesheim;3;VR Alter Birsstadt;3;VR Alter Birsstadt;10020;120;56;64;824;882;-58;3;9;10029
1997;2762;Allschwil;1301;Bezirk Arlesheim;1;VR Alter und Gesundheit ABS;1;VR Alter und Gesundheit ABS;18805;173;177;-4;1194;1153;41;1;38;18843
1997;2763;Arlesheim;1301;Bezirk Arlesheim;3;VR Alter Birsstadt;3;VR Alter Birsstadt;8459;77;63;14;557;571;-14;3;3;8462
1997;2764;Biel-Benken;1301;Bezirk Arlesheim;4;VR BPA Leimental;4;VR BPA Leimental;2414;15;13;2;210;122;88;0;90;2504
1997;2765;Binningen;1301;Bezirk Arlesheim;1;VR Alter und Gesundheit ABS;1;VR Alter und Gesundheit ABS;13984;113;129;-16;1010;981;29;2;15;13999
1997;2766;Birsfelden;1301;Bezirk Arlesheim;2;VR APG Rheintal;2;VR APG Rheintal;11094;97;113;-16;691;796;-105;0;-121;10973
1997;2767;Bottmingen;1301;Bezirk Arlesheim;4;VR BPA Leimental;4;VR BPA Leimental;5480;34;27;7;387;426;-39;1;-31;5449
1997;2768;Ettingen;1301;Bezirk Arlesheim;4;VR BPA Leimental;4;VR BPA Leimental;4800;52;23;29;285;329;-44;0;-15;4785
1997;2769;Münchenstein;1301;Bezirk Arlesheim;3;VR Alter Birsstadt;3;VR Alter Birsstadt;11720;106;91;15;747;745;2;4;21;11741
1997;2770;Muttenz;1301;Bezirk Arlesheim;2;VR APG Rheintal;2;VR APG Rheintal;16665;115;141;-26;854;811;43;2;19;16684
1997;2771;Oberwil (BL);1301;Bezirk Arlesheim;4;VR BPA Leimental;4;VR BPA Leimental;9112;100;64;36;718;630;88;2;126;9238
1997;2772;Pfeffingen;1301;Bezirk Arlesheim;3;VR Alter Birsstadt;3;VR Alter Birsstadt;1867;16;9;7;143;103;40;0;47;1914
1997;2773;Reinach (BL);1301;Bezirk Arlesheim;3;VR Alter Birsstadt;3;VR Alter Birsstadt;18028;150;118;32;1345;1254;91;5;128;18156
1997;2774;Schönenbuch;1301;Bezirk Arlesheim;1;VR Alter und Gesundheit ABS;1;VR Alter und Gesundheit ABS;1101;9;3;6;110;71;39;0;45;1146
1997;2775;Therwil;1301;Bezirk Arlesheim;4;VR BPA Leimental;4;VR BPA Leimental;7626;74;41;33;633;502;131;0;164;7790
1997;2781;Blauen;1302;Bezirk Laufen;5;VR APG Laufental;5;VR APG Laufental;630;3;3;0;45;29;16;0;16;646
1997;2782;Brislach;1302;Bezirk Laufen;5;VR APG Laufental;5;VR APG Laufental;1290;16;9;7;98;84;14;0;21;1311
1997;2783;Burg im Leimental;1302;Bezirk Laufen;4;VR BPA Leimental;4;VR BPA Leimental;225;4;0;4;18;20;-2;0;2;227
1997;2784;Dittingen;1302;Bezirk Laufen;5;VR APG Laufental;5;VR APG Laufental;707;12;8;4;77;82;-5;0;-1;706
1997;2785;Duggingen;1302;Bezirk Laufen;3;VR Alter Birsstadt;3;VR Alter Birsstadt;1031;9;8;1;119;92;27;0;28;1059
1997;2786;Grellingen;1302;Bezirk Laufen;5;VR APG Laufental;5;VR APG Laufental;1617;22;16;6;138;164;-26;37;17;1634
1997;2787;Laufen;1302;Bezirk Laufen;5;VR APG Laufental;5;VR APG Laufental;4767;45;29;16;363;364;-1;0;15;4782
1997;2788;Liesberg;1302;Bezirk Laufen;5;VR APG Laufental;5;VR APG Laufental;1180;15;13;2;81;76;5;0;7;1187
1997;2789;Nenzlingen;1302;Bezirk Laufen;5;VR APG Laufental;5;VR APG Laufental;367;8;5;3;36;43;-7;0;-4;363
1997;2790;Roggenburg;1302;Bezirk Laufen;5;VR APG Laufental;5;VR APG Laufental;243;3;0;3;23;6;17;0;20;263
1997;2791;Röschenz;1302;Bezirk Laufen;5;VR APG Laufental;5;VR APG Laufental;1516;11;16;-5;130;85;45;0;40;1556
1997;2792;Wahlen;1302;Bezirk Laufen;5;VR APG Laufental;5;VR APG Laufental;1099;14;13;1;127;80;47;1;49;1148
1997;2793;Zwingen;1302;Bezirk Laufen;5;VR APG Laufental;5;VR APG Laufental;1973;29;13;16;225;199;26;3;45;2018
1997;2821;Arisdorf;1303;Bezirk Liestal;6;VR Alters- und Pflegeregion Liestal;6;VR Alters- und Pflegeregion Liestal;1250;20;7;13;121;49;72;0;85;1335
1997;2822;Augst;1303;Bezirk Liestal;2;VR APG Rheintal;2;VR APG Rheintal;803;9;3;6;97;106;-9;0;-3;800
1997;2823;Bubendorf;1303;Bezirk Liestal;6;VR Alters- und Pflegeregion Liestal;6;VR Alters- und Pflegeregion Liestal;4049;59;21;38;380;289;91;0;129;4178
1997;2824;Frenkendorf;1303;Bezirk Liestal;6;VR Alters- und Pflegeregion Liestal;6;VR Alters- und Pflegeregion Liestal;5882;52;42;10;460;522;-62;-1;-53;5829
1997;2825;Füllinsdorf;1303;Bezirk Liestal;6;VR Alters- und Pflegeregion Liestal;6;VR Alters- und Pflegeregion Liestal;4134;46;19;27;365;365;0;1;28;4162
1997;2826;Giebenach;1303;Bezirk Liestal;2;VR APG Rheintal;2;VR APG Rheintal;784;6;6;0;91;105;-14;0;-14;770
1997;2827;Hersberg;1303;Bezirk Liestal;6;VR Alters- und Pflegeregion Liestal;6;VR Alters- und Pflegeregion Liestal;266;2;0;2;8;15;-7;0;-5;261
1997;2828;Lausen;1303;Bezirk Liestal;6;VR Alters- und Pflegeregion Liestal;6;VR Alters- und Pflegeregion Liestal;4457;40;27;13;433;361;72;1;86;4543
1997;2829;Liestal;1303;Bezirk Liestal;6;VR Alters- und Pflegeregion Liestal;6;VR Alters- und Pflegeregion Liestal;12526;139;111;28;1107;1155;-48;1;-19;12507
1997;2830;Lupsingen;1303;Bezirk Liestal;6;VR Alters- und Pflegeregion Liestal;6;VR Alters- und Pflegeregion Liestal;1076;7;12;-5;88;34;54;0;49;1125
1997;2831;Pratteln;1303;Bezirk Liestal;2;VR APG Rheintal;2;VR APG Rheintal;15394;157;124;33;877;1065;-188;7;-148;15246
1997;2832;Ramlinsburg;1303;Bezirk Liestal;10;VR Waldenburgertal plus;8;VR Waldenburgertal plus;513;4;5;-1;48;26;22;0;21;534
1997;2833;Seltisberg;1303;Bezirk Liestal;6;VR Alters- und Pflegeregion Liestal;6;VR Alters- und Pflegeregion Liestal;1193;15;6;9;79;81;-2;0;7;1200
1997;2834;Ziefen;1303;Bezirk Liestal;6;VR Alters- und Pflegeregion Liestal;6;VR Alters- und Pflegeregion Liestal;1278;16;11;5;125;62;63;0;68;1346
1997;2841;Anwil;1304;Bezirk Sissach;9;VR Farnsberg plus;7;Planungsregion Oberbaselbiet;449;3;7;-4;36;36;0;-5;-9;440
1997;2842;Böckten;1304;Bezirk Sissach;7;VR Oberbaselbiet;7;Planungsregion Oberbaselbiet;680;5;4;1;53;57;-4;1;-2;678
1997;2843;Buckten;1304;Bezirk Sissach;8;VR Oberes Homburgertal;7;Planungsregion Oberbaselbiet;703;5;5;0;48;60;-12;0;-12;691
1997;2844;Buus;1304;Bezirk Sissach;9;VR Farnsberg plus;7;Planungsregion Oberbaselbiet;845;11;5;6;66;34;32;0;38;883
1997;2845;Diepflingen;1304;Bezirk Sissach;7;VR Oberbaselbiet;7;Planungsregion Oberbaselbiet;462;6;3;3;27;27;0;0;3;465
1997;2846;Gelterkinden;1304;Bezirk Sissach;7;VR Oberbaselbiet;7;Planungsregion Oberbaselbiet;5359;43;51;-8;306;319;-13;1;-20;5339
1997;2847;Häfelfingen;1304;Bezirk Sissach;8;VR Oberes Homburgertal;7;Planungsregion Oberbaselbiet;252;2;1;1;17;14;3;0;4;256
1997;2848;Hemmiken;1304;Bezirk Sissach;9;VR Farnsberg plus;7;Planungsregion Oberbaselbiet;260;2;2;0;20;7;13;0;13;273
1997;2849;Itingen;1304;Bezirk Sissach;7;VR Oberbaselbiet;7;Planungsregion Oberbaselbiet;1588;15;12;3;102;132;-30;0;-27;1561
1997;2850;Känerkinden;1304;Bezirk Sissach;8;VR Oberes Homburgertal;7;Planungsregion Oberbaselbiet;489;7;4;3;20;13;7;-5;5;494
1997;2851;Kilchberg (BL);1304;Bezirk Sissach;9;VR Farnsberg plus;7;Planungsregion Oberbaselbiet;99;1;2;-1;4;6;-2;0;-3;96
1997;2852;Läufelfingen;1304;Bezirk Sissach;8;VR Oberes Homburgertal;7;Planungsregion Oberbaselbiet;1274;20;13;7;97;82;15;0;22;1296
1997;2853;Maisprach;1304;Bezirk Sissach;9;VR Farnsberg plus;7;Planungsregion Oberbaselbiet;810;10;2;8;71;41;30;0;38;848
1997;2854;Nusshof;1304;Bezirk Sissach;7;VR Oberbaselbiet;7;Planungsregion Oberbaselbiet;176;3;2;1;11;5;6;0;7;183
1997;2855;Oltingen;1304;Bezirk Sissach;9;VR Farnsberg plus;7;Planungsregion Oberbaselbiet;415;2;3;-1;10;7;3;0;2;417
1997;2856;Ormalingen;1304;Bezirk Sissach;7;VR Oberbaselbiet;7;Planungsregion Oberbaselbiet;1795;17;17;0;110;123;-13;1;-12;1783
1997;2857;Rickenbach (BL);1304;Bezirk Sissach;9;VR Farnsberg plus;7;Planungsregion Oberbaselbiet;512;10;2;8;45;54;-9;0;-1;511
1997;2858;Rothenfluh;1304;Bezirk Sissach;9;VR Farnsberg plus;7;Planungsregion Oberbaselbiet;676;10;4;6;45;40;5;0;11;687
1997;2859;Rümlingen;1304;Bezirk Sissach;8;VR Oberes Homburgertal;7;Planungsregion Oberbaselbiet;319;3;3;0;41;30;11;0;11;330
1997;2860;Rünenberg;1304;Bezirk Sissach;9;VR Farnsberg plus;7;Planungsregion Oberbaselbiet;672;13;5;8;64;27;37;0;45;717
1997;2861;Sissach;1304;Bezirk Sissach;7;VR Oberbaselbiet;7;Planungsregion Oberbaselbiet;5247;48;52;-4;386;376;10;0;6;5253
1997;2862;Tecknau;1304;Bezirk Sissach;7;VR Oberbaselbiet;7;Planungsregion Oberbaselbiet;790;13;4;9;118;60;58;0;67;857
1997;2863;Tenniken;1304;Bezirk Sissach;7;VR Oberbaselbiet;7;Planungsregion Oberbaselbiet;930;7;7;0;56;52;4;0;4;934
1997;2864;Thürnen;1304;Bezirk Sissach;7;VR Oberbaselbiet;7;Planungsregion Oberbaselbiet;1011;10;4;6;167;104;63;0;69;1080
1997;2865;Wenslingen;1304;Bezirk Sissach;7;VR Oberbaselbiet;7;Planungsregion Oberbaselbiet;642;6;8;-2;22;30;-8;0;-10;632
1997;2866;Wintersingen;1304;Bezirk Sissach;9;VR Farnsberg plus;7;Planungsregion Oberbaselbiet;576;8;5;3;34;24;10;0;13;589
1997;2867;Wittinsburg;1304;Bezirk Sissach;7;VR Oberbaselbiet;7;Planungsregion Oberbaselbiet;309;4;2;2;17;16;1;0;3;312
1997;2868;Zeglingen;1304;Bezirk Sissach;9;VR Farnsberg plus;7;Planungsregion Oberbaselbiet;482;2;5;-3;21;27;-6;0;-9;473
1997;2869;Zunzgen;1304;Bezirk Sissach;7;VR Oberbaselbiet;7;Planungsregion Oberbaselbiet;2526;37;13;24;149;171;-22;0;2;2528
1997;2881;Arboldswil;1305;Bezirk Waldenburg;10;VR Waldenburgertal plus;8;VR Waldenburgertal plus;479;6;4;2;19;40;-21;0;-19;460
1997;2882;Bennwil;1305;Bezirk Waldenburg;10;VR Waldenburgertal plus;8;VR Waldenburgertal plus;543;5;6;-1;45;45;0;0;-1;542
1997;2883;Bretzwil;1305;Bezirk Waldenburg;10;VR Waldenburgertal plus;8;VR Waldenburgertal plus;693;10;3;7;32;28;4;0;11;704
1997;2884;Diegten;1305;Bezirk Waldenburg;7;VR Oberbaselbiet;7;Planungsregion Oberbaselbiet;1266;15;2;13;100;112;-12;0;1;1267
1997;2885;Eptingen;1305;Bezirk Waldenburg;7;VR Oberbaselbiet;7;Planungsregion Oberbaselbiet;592;2;3;-1;30;44;-14;0;-15;577
1997;2886;Hölstein;1305;Bezirk Waldenburg;10;VR Waldenburgertal plus;8;VR Waldenburgertal plus;2020;24;15;9;148;181;-33;0;-24;1996
1997;2887;Lampenberg;1305;Bezirk Waldenburg;10;VR Waldenburgertal plus;8;VR Waldenburgertal plus;486;3;6;-3;22;18;4;0;1;487
1997;2888;Langenbruck;1305;Bezirk Waldenburg;10;VR Waldenburgertal plus;8;VR Waldenburgertal plus;983;14;11;3;87;64;23;0;26;1009
1997;2889;Lauwil;1305;Bezirk Waldenburg;10;VR Waldenburgertal plus;8;VR Waldenburgertal plus;318;1;5;-4;30;24;6;0;2;320
1997;2890;Liedertswil;1305;Bezirk Waldenburg;10;VR Waldenburgertal plus;8;VR Waldenburgertal plus;153;1;1;0;5;13;-8;0;-8;145
1997;2891;Niederdorf;1305;Bezirk Waldenburg;10;VR Waldenburgertal plus;8;VR Waldenburgertal plus;1662;17;16;1;86;94;-8;0;-7;1655
1997;2892;Oberdorf (BL);1305;Bezirk Waldenburg;10;VR Waldenburgertal plus;8;VR Waldenburgertal plus;2317;23;19;4;179;161;18;0;22;2339
1997;2893;Reigoldswil;1305;Bezirk Waldenburg;10;VR Waldenburgertal plus;8;VR Waldenburgertal plus;1443;20;17;3;88;73;15;1;19;1462
1997;2894;Titterten;1305;Bezirk Waldenburg;10;VR Waldenburgertal plus;8;VR Waldenburgertal plus;398;2;6;-4;46;36;10;0;6;404
1997;2895;Waldenburg;1305;Bezirk Waldenburg;10;VR Waldenburgertal plus;8;VR Waldenburgertal plus;1409;20;10;10;91;111;-20;1;-9;1400
1998;2761;Aesch (BL);1301;Bezirk Arlesheim;3;VR Alter Birsstadt;3;VR Alter Birsstadt;10029;111;42;69;785;820;-35;2;36;10065
1998;2762;Allschwil;1301;Bezirk Arlesheim;1;VR Alter und Gesundheit ABS;1;VR Alter und Gesundheit ABS;18843;178;168;10;1122;1243;-121;2;-109;18734
1998;2763;Arlesheim;1301;Bezirk Arlesheim;3;VR Alter Birsstadt;3;VR Alter Birsstadt;8462;79;69;10;656;618;38;1;49;8511
1998;2764;Biel-Benken;1301;Bezirk Arlesheim;4;VR BPA Leimental;4;VR BPA Leimental;2504;16;6;10;195;132;63;0;73;2577
1998;2765;Binningen;1301;Bezirk Arlesheim;1;VR Alter und Gesundheit ABS;1;VR Alter und Gesundheit ABS;13999;109;148;-39;1050;1124;-74;1;-112;13887
1998;2766;Birsfelden;1301;Bezirk Arlesheim;2;VR APG Rheintal;2;VR APG Rheintal;10973;91;86;5;684;776;-92;2;-85;10888
1998;2767;Bottmingen;1301;Bezirk Arlesheim;4;VR BPA Leimental;4;VR BPA Leimental;5449;54;34;20;487;488;-1;0;19;5468
1998;2768;Ettingen;1301;Bezirk Arlesheim;4;VR BPA Leimental;4;VR BPA Leimental;4785;44;20;24;345;339;6;0;30;4815
1998;2769;Münchenstein;1301;Bezirk Arlesheim;3;VR Alter Birsstadt;3;VR Alter Birsstadt;11741;121;115;6;725;831;-106;1;-99;11642
1998;2770;Muttenz;1301;Bezirk Arlesheim;2;VR APG Rheintal;2;VR APG Rheintal;16684;128;161;-33;1083;1015;68;5;40;16724
1998;2771;Oberwil (BL);1301;Bezirk Arlesheim;4;VR BPA Leimental;4;VR BPA Leimental;9238;89;66;23;817;788;29;1;53;9291
1998;2772;Pfeffingen;1301;Bezirk Arlesheim;3;VR Alter Birsstadt;3;VR Alter Birsstadt;1914;10;12;-2;195;115;80;0;78;1992
1998;2773;Reinach (BL);1301;Bezirk Arlesheim;3;VR Alter Birsstadt;3;VR Alter Birsstadt;18156;150;111;39;1299;1154;145;1;185;18341
1998;2774;Schönenbuch;1301;Bezirk Arlesheim;1;VR Alter und Gesundheit ABS;1;VR Alter und Gesundheit ABS;1146;8;3;5;120;47;73;1;79;1225
1998;2775;Therwil;1301;Bezirk Arlesheim;4;VR BPA Leimental;4;VR BPA Leimental;7790;85;51;34;721;554;167;2;203;7993
1998;2781;Blauen;1302;Bezirk Laufen;5;VR APG Laufental;5;VR APG Laufental;646;7;1;6;32;36;-4;0;2;648
1998;2782;Brislach;1302;Bezirk Laufen;5;VR APG Laufental;5;VR APG Laufental;1311;18;17;1;109;78;31;0;32;1343
1998;2783;Burg im Leimental;1302;Bezirk Laufen;4;VR BPA Leimental;4;VR BPA Leimental;227;3;4;-1;26;10;16;0;15;242
1998;2784;Dittingen;1302;Bezirk Laufen;5;VR APG Laufental;5;VR APG Laufental;706;6;8;-2;65;55;10;0;8;714
1998;2785;Duggingen;1302;Bezirk Laufen;3;VR Alter Birsstadt;3;VR Alter Birsstadt;1059;14;6;8;85;66;19;0;27;1086
1998;2786;Grellingen;1302;Bezirk Laufen;5;VR APG Laufental;5;VR APG Laufental;1634;28;9;19;161;168;-7;0;12;1646
1998;2787;Laufen;1302;Bezirk Laufen;5;VR APG Laufental;5;VR APG Laufental;4782;46;31;15;348;291;57;0;72;4854
1998;2788;Liesberg;1302;Bezirk Laufen;5;VR APG Laufental;5;VR APG Laufental;1187;12;4;8;62;62;0;0;8;1195
1998;2789;Nenzlingen;1302;Bezirk Laufen;5;VR APG Laufental;5;VR APG Laufental;363;2;3;-1;25;35;-10;0;-11;352
1998;2790;Roggenburg;1302;Bezirk Laufen;5;VR APG Laufental;5;VR APG Laufental;263;3;2;1;6;17;-11;0;-10;253
1998;2791;Röschenz;1302;Bezirk Laufen;5;VR APG Laufental;5;VR APG Laufental;1556;21;13;8;92;75;17;0;25;1581
1998;2792;Wahlen;1302;Bezirk Laufen;5;VR APG Laufental;5;VR APG Laufental;1148;15;12;3;118;58;60;0;63;1211
1998;2793;Zwingen;1302;Bezirk Laufen;5;VR APG Laufental;5;VR APG Laufental;2018;33;8;25;186;160;26;-100;-49;1969
1998;2821;Arisdorf;1303;Bezirk Liestal;6;VR Alters- und Pflegeregion Liestal;6;VR Alters- und Pflegeregion Liestal;1335;20;11;9;133;97;36;0;45;1380
1998;2822;Augst;1303;Bezirk Liestal;2;VR APG Rheintal;2;VR APG Rheintal;800;7;6;1;85;78;7;0;8;808
1998;2823;Bubendorf;1303;Bezirk Liestal;6;VR Alters- und Pflegeregion Liestal;6;VR Alters- und Pflegeregion Liestal;4178;56;25;31;407;263;144;0;175;4353
1998;2824;Frenkendorf;1303;Bezirk Liestal;6;VR Alters- und Pflegeregion Liestal;6;VR Alters- und Pflegeregion Liestal;5829;66;45;21;551;513;38;1;60;5889
1998;2825;Füllinsdorf;1303;Bezirk Liestal;6;VR Alters- und Pflegeregion Liestal;6;VR Alters- und Pflegeregion Liestal;4162;33;27;6;379;416;-37;1;-30;4132
1998;2826;Giebenach;1303;Bezirk Liestal;2;VR APG Rheintal;2;VR APG Rheintal;770;6;3;3;122;68;54;0;57;827
1998;2827;Hersberg;1303;Bezirk Liestal;6;VR Alters- und Pflegeregion Liestal;6;VR Alters- und Pflegeregion Liestal;261;2;3;-1;15;15;0;0;-1;260
1998;2828;Lausen;1303;Bezirk Liestal;6;VR Alters- und Pflegeregion Liestal;6;VR Alters- und Pflegeregion Liestal;4543;47;33;14;406;378;28;1;43;4586
1998;2829;Liestal;1303;Bezirk Liestal;6;VR Alters- und Pflegeregion Liestal;6;VR Alters- und Pflegeregion Liestal;12507;129;112;17;1115;1155;-40;2;-21;12486
1998;2830;Lupsingen;1303;Bezirk Liestal;6;VR Alters- und Pflegeregion Liestal;6;VR Alters- und Pflegeregion Liestal;1125;12;7;5;86;54;32;0;37;1162
1998;2831;Pratteln;1303;Bezirk Liestal;2;VR APG Rheintal;2;VR APG Rheintal;15246;142;116;26;1007;1117;-110;0;-84;15162
1998;2832;Ramlinsburg;1303;Bezirk Liestal;10;VR Waldenburgertal plus;8;VR Waldenburgertal plus;534;7;2;5;90;36;54;0;59;593
1998;2833;Seltisberg;1303;Bezirk Liestal;6;VR Alters- und Pflegeregion Liestal;6;VR Alters- und Pflegeregion Liestal;1200;11;8;3;81;72;9;0;12;1212
1998;2834;Ziefen;1303;Bezirk Liestal;6;VR Alters- und Pflegeregion Liestal;6;VR Alters- und Pflegeregion Liestal;1346;14;7;7;81;75;6;0;13;1359
1998;2841;Anwil;1304;Bezirk Sissach;9;VR Farnsberg plus;7;Planungsregion Oberbaselbiet;440;8;3;5;36;24;12;0;17;457
1998;2842;Böckten;1304;Bezirk Sissach;7;VR Oberbaselbiet;7;Planungsregion Oberbaselbiet;678;9;5;4;38;37;1;0;5;683
1998;2843;Buckten;1304;Bezirk Sissach;8;VR Oberes Homburgertal;7;Planungsregion Oberbaselbiet;691;3;5;-2;50;57;-7;0;-9;682
1998;2844;Buus;1304;Bezirk Sissach;9;VR Farnsberg plus;7;Planungsregion Oberbaselbiet;883;12;8;4;40;29;11;0;15;898
1998;2845;Diepflingen;1304;Bezirk Sissach;7;VR Oberbaselbiet;7;Planungsregion Oberbaselbiet;465;3;2;1;48;33;15;0;16;481
1998;2846;Gelterkinden;1304;Bezirk Sissach;7;VR Oberbaselbiet;7;Planungsregion Oberbaselbiet;5339;57;40;17;370;318;52;0;69;5408
1998;2847;Häfelfingen;1304;Bezirk Sissach;8;VR Oberes Homburgertal;7;Planungsregion Oberbaselbiet;256;2;1;1;12;15;-3;0;-2;254
1998;2848;Hemmiken;1304;Bezirk Sissach;9;VR Farnsberg plus;7;Planungsregion Oberbaselbiet;273;3;2;1;16;14;2;0;3;276
1998;2849;Itingen;1304;Bezirk Sissach;7;VR Oberbaselbiet;7;Planungsregion Oberbaselbiet;1561;18;13;5;161;120;41;0;46;1607
1998;2850;Känerkinden;1304;Bezirk Sissach;8;VR Oberes Homburgertal;7;Planungsregion Oberbaselbiet;494;6;0;6;30;45;-15;0;-9;485
1998;2851;Kilchberg (BL);1304;Bezirk Sissach;9;VR Farnsberg plus;7;Planungsregion Oberbaselbiet;96;0;0;0;13;4;9;0;9;105
1998;2852;Läufelfingen;1304;Bezirk Sissach;8;VR Oberes Homburgertal;7;Planungsregion Oberbaselbiet;1296;4;13;-9;76;92;-16;0;-25;1271
1998;2853;Maisprach;1304;Bezirk Sissach;9;VR Farnsberg plus;7;Planungsregion Oberbaselbiet;848;10;7;3;49;29;20;0;23;871
1998;2854;Nusshof;1304;Bezirk Sissach;7;VR Oberbaselbiet;7;Planungsregion Oberbaselbiet;183;1;1;0;12;5;7;0;7;190
1998;2855;Oltingen;1304;Bezirk Sissach;9;VR Farnsberg plus;7;Planungsregion Oberbaselbiet;417;3;5;-2;11;12;-1;0;-3;414
1998;2856;Ormalingen;1304;Bezirk Sissach;7;VR Oberbaselbiet;7;Planungsregion Oberbaselbiet;1783;14;8;6;166;104;62;0;68;1851
1998;2857;Rickenbach (BL);1304;Bezirk Sissach;9;VR Farnsberg plus;7;Planungsregion Oberbaselbiet;511;6;5;1;29;42;-13;1;-11;500
1998;2858;Rothenfluh;1304;Bezirk Sissach;9;VR Farnsberg plus;7;Planungsregion Oberbaselbiet;687;8;4;4;31;37;-6;0;-2;685
1998;2859;Rümlingen;1304;Bezirk Sissach;8;VR Oberes Homburgertal;7;Planungsregion Oberbaselbiet;330;7;2;5;20;31;-11;0;-6;324
1998;2860;Rünenberg;1304;Bezirk Sissach;9;VR Farnsberg plus;7;Planungsregion Oberbaselbiet;717;7;5;2;43;45;-2;0;0;717
1998;2861;Sissach;1304;Bezirk Sissach;7;VR Oberbaselbiet;7;Planungsregion Oberbaselbiet;5253;46;54;-8;514;431;83;1;76;5329
1998;2862;Tecknau;1304;Bezirk Sissach;7;VR Oberbaselbiet;7;Planungsregion Oberbaselbiet;857;10;14;-4;67;68;-1;0;-5;852
1998;2863;Tenniken;1304;Bezirk Sissach;7;VR Oberbaselbiet;7;Planungsregion Oberbaselbiet;934;10;5;5;45;47;-2;0;3;937
1998;2864;Thürnen;1304;Bezirk Sissach;7;VR Oberbaselbiet;7;Planungsregion Oberbaselbiet;1080;9;9;0;131;82;49;0;49;1129
1998;2865;Wenslingen;1304;Bezirk Sissach;7;VR Oberbaselbiet;7;Planungsregion Oberbaselbiet;632;9;5;4;32;33;-1;0;3;635
1998;2866;Wintersingen;1304;Bezirk Sissach;9;VR Farnsberg plus;7;Planungsregion Oberbaselbiet;589;12;9;3;16;12;4;0;7;596
1998;2867;Wittinsburg;1304;Bezirk Sissach;7;VR Oberbaselbiet;7;Planungsregion Oberbaselbiet;312;10;4;6;19;10;9;0;15;327
1998;2868;Zeglingen;1304;Bezirk Sissach;9;VR Farnsberg plus;7;Planungsregion Oberbaselbiet;473;8;4;4;25;24;1;-2;3;476
1998;2869;Zunzgen;1304;Bezirk Sissach;7;VR Oberbaselbiet;7;Planungsregion Oberbaselbiet;2528;14;19;-5;118;137;-19;0;-24;2504
1998;2881;Arboldswil;1305;Bezirk Waldenburg;10;VR Waldenburgertal plus;8;VR Waldenburgertal plus;460;4;2;2;47;31;16;0;18;478
1998;2882;Bennwil;1305;Bezirk Waldenburg;10;VR Waldenburgertal plus;8;VR Waldenburgertal plus;542;6;1;5;75;20;55;0;60;602
1998;2883;Bretzwil;1305;Bezirk Waldenburg;10;VR Waldenburgertal plus;8;VR Waldenburgertal plus;704;9;3;6;37;23;14;0;20;724
1998;2884;Diegten;1305;Bezirk Waldenburg;7;VR Oberbaselbiet;7;Planungsregion Oberbaselbiet;1267;18;4;14;168;94;74;0;88;1355
1998;2885;Eptingen;1305;Bezirk Waldenburg;7;VR Oberbaselbiet;7;Planungsregion Oberbaselbiet;577;5;7;-2;32;32;0;0;-2;575
1998;2886;Hölstein;1305;Bezirk Waldenburg;10;VR Waldenburgertal plus;8;VR Waldenburgertal plus;1996;19;10;9;186;161;25;0;34;2030
1998;2887;Lampenberg;1305;Bezirk Waldenburg;10;VR Waldenburgertal plus;8;VR Waldenburgertal plus;487;1;3;-2;14;26;-12;0;-14;473
1998;2888;Langenbruck;1305;Bezirk Waldenburg;10;VR Waldenburgertal plus;8;VR Waldenburgertal plus;1009;15;12;3;52;76;-24;1;-20;989
1998;2889;Lauwil;1305;Bezirk Waldenburg;10;VR Waldenburgertal plus;8;VR Waldenburgertal plus;320;5;4;1;19;28;-9;0;-8;312
1998;2890;Liedertswil;1305;Bezirk Waldenburg;10;VR Waldenburgertal plus;8;VR Waldenburgertal plus;145;1;0;1;13;4;9;0;10;155
1998;2891;Niederdorf;1305;Bezirk Waldenburg;10;VR Waldenburgertal plus;8;VR Waldenburgertal plus;1655;24;25;-1;140;73;67;0;66;1721
1998;2892;Oberdorf (BL);1305;Bezirk Waldenburg;10;VR Waldenburgertal plus;8;VR Waldenburgertal plus;2339;30;23;7;171;151;20;0;27;2366
1998;2893;Reigoldswil;1305;Bezirk Waldenburg;10;VR Waldenburgertal plus;8;VR Waldenburgertal plus;1462;13;9;4;111;92;19;0;23;1485
1998;2894;Titterten;1305;Bezirk Waldenburg;10;VR Waldenburgertal plus;8;VR Waldenburgertal plus;404;3;0;3;25;29;-4;0;-1;403
1998;2895;Waldenburg;1305;Bezirk Waldenburg;10;VR Waldenburgertal plus;8;VR Waldenburgertal plus;1400;26;21;5;108;96;12;0;17;1417
1999;2761;Aesch (BL);1301;Bezirk Arlesheim;3;VR Alter Birsstadt;3;VR Alter Birsstadt;10065;109;43;66;794;822;-28;3;41;10106
1999;2762;Allschwil;1301;Bezirk Arlesheim;1;VR Alter und Gesundheit ABS;1;VR Alter und Gesundheit ABS;18734;138;163;-25;983;1252;-269;0;-294;18440
1999;2763;Arlesheim;1301;Bezirk Arlesheim;3;VR Alter Birsstadt;3;VR Alter Birsstadt;8511;73;73;0;628;606;22;1;23;8534
1999;2764;Biel-Benken;1301;Bezirk Arlesheim;4;VR BPA Leimental;4;VR BPA Leimental;2577;25;13;12;229;109;120;0;132;2709
1999;2765;Binningen;1301;Bezirk Arlesheim;1;VR Alter und Gesundheit ABS;1;VR Alter und Gesundheit ABS;13887;130;143;-13;1060;984;76;0;63;13950
1999;2766;Birsfelden;1301;Bezirk Arlesheim;2;VR APG Rheintal;2;VR APG Rheintal;10888;120;109;11;627;635;-8;1;4;10892
1999;2767;Bottmingen;1301;Bezirk Arlesheim;4;VR BPA Leimental;4;VR BPA Leimental;5468;34;37;-3;485;410;75;1;73;5541
1999;2768;Ettingen;1301;Bezirk Arlesheim;4;VR BPA Leimental;4;VR BPA Leimental;4815;46;21;25;305;342;-37;0;-12;4803
1999;2769;Münchenstein;1301;Bezirk Arlesheim;3;VR Alter Birsstadt;3;VR Alter Birsstadt;11642;106;100;6;784;797;-13;3;-4;11638
1999;2770;Muttenz;1301;Bezirk Arlesheim;2;VR APG Rheintal;2;VR APG Rheintal;16724;122;126;-4;849;846;3;2;1;16725
1999;2771;Oberwil (BL);1301;Bezirk Arlesheim;4;VR BPA Leimental;4;VR BPA Leimental;9291;78;57;21;808;698;110;1;132;9423
1999;2772;Pfeffingen;1301;Bezirk Arlesheim;3;VR Alter Birsstadt;3;VR Alter Birsstadt;1992;14;11;3;155;99;56;0;59;2051
1999;2773;Reinach (BL);1301;Bezirk Arlesheim;3;VR Alter Birsstadt;3;VR Alter Birsstadt;18341;176;109;67;1273;1345;-72;0;-5;18336
1999;2774;Schönenbuch;1301;Bezirk Arlesheim;1;VR Alter und Gesundheit ABS;1;VR Alter und Gesundheit ABS;1225;10;7;3;84;69;15;0;18;1243
1999;2775;Therwil;1301;Bezirk Arlesheim;4;VR BPA Leimental;4;VR BPA Leimental;7993;82;54;28;806;469;337;3;368;8361
1999;2781;Blauen;1302;Bezirk Laufen;5;VR APG Laufental;5;VR APG Laufental;648;9;3;6;29;21;8;0;14;662
1999;2782;Brislach;1302;Bezirk Laufen;5;VR APG Laufental;5;VR APG Laufental;1343;20;15;5;99;56;43;0;48;1391
1999;2783;Burg im Leimental;1302;Bezirk Laufen;4;VR BPA Leimental;4;VR BPA Leimental;242;3;2;1;23;25;-2;0;-1;241
1999;2784;Dittingen;1302;Bezirk Laufen;5;VR APG Laufental;5;VR APG Laufental;714;6;5;1;59;44;15;0;16;730
1999;2785;Duggingen;1302;Bezirk Laufen;3;VR Alter Birsstadt;3;VR Alter Birsstadt;1086;16;11;5;154;62;92;0;97;1183
1999;2786;Grellingen;1302;Bezirk Laufen;5;VR APG Laufental;5;VR APG Laufental;1646;17;12;5;116;123;-7;0;-2;1644
1999;2787;Laufen;1302;Bezirk Laufen;5;VR APG Laufental;5;VR APG Laufental;4854;37;44;-7;299;228;71;0;64;4918
1999;2788;Liesberg;1302;Bezirk Laufen;5;VR APG Laufental;5;VR APG Laufental;1195;18;11;7;58;57;1;0;8;1203
1999;2789;Nenzlingen;1302;Bezirk Laufen;5;VR APG Laufental;5;VR APG Laufental;352;0;1;-1;14;16;-2;0;-3;349
1999;2790;Roggenburg;1302;Bezirk Laufen;5;VR APG Laufental;5;VR APG Laufental;253;4;4;0;18;21;-3;0;-3;250
1999;2791;Röschenz;1302;Bezirk Laufen;5;VR APG Laufental;5;VR APG Laufental;1581;12;16;-4;114;102;12;0;8;1589
1999;2792;Wahlen;1302;Bezirk Laufen;5;VR APG Laufental;5;VR APG Laufental;1211;20;8;12;66;62;4;0;16;1227
1999;2793;Zwingen;1302;Bezirk Laufen;5;VR APG Laufental;5;VR APG Laufental;1969;23;14;9;227;183;44;0;53;2022
1999;2821;Arisdorf;1303;Bezirk Liestal;6;VR Alters- und Pflegeregion Liestal;6;VR Alters- und Pflegeregion Liestal;1380;12;10;2;74;60;14;0;16;1396
1999;2822;Augst;1303;Bezirk Liestal;2;VR APG Rheintal;2;VR APG Rheintal;808;10;5;5;112;114;-2;0;3;811
1999;2823;Bubendorf;1303;Bezirk Liestal;6;VR Alters- und Pflegeregion Liestal;6;VR Alters- und Pflegeregion Liestal;4353;39;16;23;299;222;77;-84;16;4369
1999;2824;Frenkendorf;1303;Bezirk Liestal;6;VR Alters- und Pflegeregion Liestal;6;VR Alters- und Pflegeregion Liestal;5889;64;39;25;548;556;-8;0;17;5906
1999;2825;Füllinsdorf;1303;Bezirk Liestal;6;VR Alters- und Pflegeregion Liestal;6;VR Alters- und Pflegeregion Liestal;4132;29;31;-2;397;390;7;1;6;4138
1999;2826;Giebenach;1303;Bezirk Liestal;2;VR APG Rheintal;2;VR APG Rheintal;827;9;8;1;70;72;-2;0;-1;826
1999;2827;Hersberg;1303;Bezirk Liestal;6;VR Alters- und Pflegeregion Liestal;6;VR Alters- und Pflegeregion Liestal;260;4;1;3;9;13;-4;1;0;260
1999;2828;Lausen;1303;Bezirk Liestal;6;VR Alters- und Pflegeregion Liestal;6;VR Alters- und Pflegeregion Liestal;4586;40;40;0;412;378;34;1;35;4621
1999;2829;Liestal;1303;Bezirk Liestal;6;VR Alters- und Pflegeregion Liestal;6;VR Alters- und Pflegeregion Liestal;12486;117;101;16;1190;948;242;4;262;12748
1999;2830;Lupsingen;1303;Bezirk Liestal;6;VR Alters- und Pflegeregion Liestal;6;VR Alters- und Pflegeregion Liestal;1162;18;4;14;81;50;31;0;45;1207
1999;2831;Pratteln;1303;Bezirk Liestal;2;VR APG Rheintal;2;VR APG Rheintal;15162;140;130;10;973;948;25;1;36;15198
1999;2832;Ramlinsburg;1303;Bezirk Liestal;10;VR Waldenburgertal plus;8;VR Waldenburgertal plus;593;7;4;3;64;29;35;0;38;631
1999;2833;Seltisberg;1303;Bezirk Liestal;6;VR Alters- und Pflegeregion Liestal;6;VR Alters- und Pflegeregion Liestal;1212;14;10;4;85;99;-14;0;-10;1202
1999;2834;Ziefen;1303;Bezirk Liestal;6;VR Alters- und Pflegeregion Liestal;6;VR Alters- und Pflegeregion Liestal;1359;22;16;6;103;81;22;0;28;1387
1999;2841;Anwil;1304;Bezirk Sissach;9;VR Farnsberg plus;7;Planungsregion Oberbaselbiet;457;10;7;3;50;27;23;0;26;483
1999;2842;Böckten;1304;Bezirk Sissach;7;VR Oberbaselbiet;7;Planungsregion Oberbaselbiet;683;11;2;9;67;47;20;0;29;712
1999;2843;Buckten;1304;Bezirk Sissach;8;VR Oberes Homburgertal;7;Planungsregion Oberbaselbiet;682;4;3;1;61;70;-9;0;-8;674
1999;2844;Buus;1304;Bezirk Sissach;9;VR Farnsberg plus;7;Planungsregion Oberbaselbiet;898;8;5;3;68;65;3;0;6;904
1999;2845;Diepflingen;1304;Bezirk Sissach;7;VR Oberbaselbiet;7;Planungsregion Oberbaselbiet;481;7;2;5;41;48;-7;0;-2;479
1999;2846;Gelterkinden;1304;Bezirk Sissach;7;VR Oberbaselbiet;7;Planungsregion Oberbaselbiet;5408;55;48;7;358;370;-12;0;-5;5403
1999;2847;Häfelfingen;1304;Bezirk Sissach;8;VR Oberes Homburgertal;7;Planungsregion Oberbaselbiet;254;3;3;0;16;17;-1;0;-1;253
1999;2848;Hemmiken;1304;Bezirk Sissach;9;VR Farnsberg plus;7;Planungsregion Oberbaselbiet;276;4;4;0;33;22;11;0;11;287
1999;2849;Itingen;1304;Bezirk Sissach;7;VR Oberbaselbiet;7;Planungsregion Oberbaselbiet;1607;12;11;1;169;133;36;0;37;1644
1999;2850;Känerkinden;1304;Bezirk Sissach;8;VR Oberes Homburgertal;7;Planungsregion Oberbaselbiet;485;7;2;5;22;15;7;0;12;497
1999;2851;Kilchberg (BL);1304;Bezirk Sissach;9;VR Farnsberg plus;7;Planungsregion Oberbaselbiet;105;0;0;0;5;1;4;0;4;109
1999;2852;Läufelfingen;1304;Bezirk Sissach;8;VR Oberes Homburgertal;7;Planungsregion Oberbaselbiet;1271;10;13;-3;123;110;13;0;10;1281
1999;2853;Maisprach;1304;Bezirk Sissach;9;VR Farnsberg plus;7;Planungsregion Oberbaselbiet;871;9;5;4;83;67;16;0;20;891
1999;2854;Nusshof;1304;Bezirk Sissach;7;VR Oberbaselbiet;7;Planungsregion Oberbaselbiet;190;2;0;2;6;2;4;0;6;196
1999;2855;Oltingen;1304;Bezirk Sissach;9;VR Farnsberg plus;7;Planungsregion Oberbaselbiet;414;4;5;-1;19;20;-1;0;-2;412
1999;2856;Ormalingen;1304;Bezirk Sissach;7;VR Oberbaselbiet;7;Planungsregion Oberbaselbiet;1851;25;9;16;141;112;29;0;45;1896
1999;2857;Rickenbach (BL);1304;Bezirk Sissach;9;VR Farnsberg plus;7;Planungsregion Oberbaselbiet;500;7;3;4;54;42;12;2;18;518
1999;2858;Rothenfluh;1304;Bezirk Sissach;9;VR Farnsberg plus;7;Planungsregion Oberbaselbiet;685;6;3;3;49;37;12;0;15;700
1999;2859;Rümlingen;1304;Bezirk Sissach;8;VR Oberes Homburgertal;7;Planungsregion Oberbaselbiet;324;4;5;-1;29;14;15;0;14;338
1999;2860;Rünenberg;1304;Bezirk Sissach;9;VR Farnsberg plus;7;Planungsregion Oberbaselbiet;717;8;5;3;54;37;17;0;20;737
1999;2861;Sissach;1304;Bezirk Sissach;7;VR Oberbaselbiet;7;Planungsregion Oberbaselbiet;5329;51;50;1;410;381;29;0;30;5359
1999;2862;Tecknau;1304;Bezirk Sissach;7;VR Oberbaselbiet;7;Planungsregion Oberbaselbiet;852;3;5;-2;115;81;34;0;32;884
1999;2863;Tenniken;1304;Bezirk Sissach;7;VR Oberbaselbiet;7;Planungsregion Oberbaselbiet;937;9;10;-1;57;55;2;0;1;938
1999;2864;Thürnen;1304;Bezirk Sissach;7;VR Oberbaselbiet;7;Planungsregion Oberbaselbiet;1129;8;3;5;165;127;38;0;43;1172
1999;2865;Wenslingen;1304;Bezirk Sissach;7;VR Oberbaselbiet;7;Planungsregion Oberbaselbiet;635;7;10;-3;46;26;20;0;17;652
1999;2866;Wintersingen;1304;Bezirk Sissach;9;VR Farnsberg plus;7;Planungsregion Oberbaselbiet;596;5;5;0;44;22;22;0;22;618
1999;2867;Wittinsburg;1304;Bezirk Sissach;7;VR Oberbaselbiet;7;Planungsregion Oberbaselbiet;327;10;0;10;14;7;7;0;17;344
1999;2868;Zeglingen;1304;Bezirk Sissach;9;VR Farnsberg plus;7;Planungsregion Oberbaselbiet;476;5;2;3;25;49;-24;0;-21;455
1999;2869;Zunzgen;1304;Bezirk Sissach;7;VR Oberbaselbiet;7;Planungsregion Oberbaselbiet;2504;28;19;9;165;214;-49;1;-39;2465
1999;2881;Arboldswil;1305;Bezirk Waldenburg;10;VR Waldenburgertal plus;8;VR Waldenburgertal plus;478;5;3;2;49;21;28;0;30;508
1999;2882;Bennwil;1305;Bezirk Waldenburg;10;VR Waldenburgertal plus;8;VR Waldenburgertal plus;602;5;2;3;61;49;12;0;15;617
1999;2883;Bretzwil;1305;Bezirk Waldenburg;10;VR Waldenburgertal plus;8;VR Waldenburgertal plus;724;10;6;4;36;35;1;0;5;729
1999;2884;Diegten;1305;Bezirk Waldenburg;7;VR Oberbaselbiet;7;Planungsregion Oberbaselbiet;1355;16;10;6;86;63;23;0;29;1384
1999;2885;Eptingen;1305;Bezirk Waldenburg;7;VR Oberbaselbiet;7;Planungsregion Oberbaselbiet;575;7;7;0;27;40;-13;0;-13;562
1999;2886;Hölstein;1305;Bezirk Waldenburg;10;VR Waldenburgertal plus;8;VR Waldenburgertal plus;2030;15;13;2;214;149;65;0;67;2097
1999;2887;Lampenberg;1305;Bezirk Waldenburg;10;VR Waldenburgertal plus;8;VR Waldenburgertal plus;473;5;2;3;29;36;-7;0;-4;469
1999;2888;Langenbruck;1305;Bezirk Waldenburg;10;VR Waldenburgertal plus;8;VR Waldenburgertal plus;989;8;9;-1;55;68;-13;0;-14;975
1999;2889;Lauwil;1305;Bezirk Waldenburg;10;VR Waldenburgertal plus;8;VR Waldenburgertal plus;312;0;5;-5;28;15;13;0;8;320
1999;2890;Liedertswil;1305;Bezirk Waldenburg;10;VR Waldenburgertal plus;8;VR Waldenburgertal plus;155;0;0;0;20;21;-1;0;-1;154
1999;2891;Niederdorf;1305;Bezirk Waldenburg;10;VR Waldenburgertal plus;8;VR Waldenburgertal plus;1721;21;18;3;135;97;38;0;41;1762
1999;2892;Oberdorf (BL);1305;Bezirk Waldenburg;10;VR Waldenburgertal plus;8;VR Waldenburgertal plus;2366;22;21;1;137;163;-26;0;-25;2341
1999;2893;Reigoldswil;1305;Bezirk Waldenburg;10;VR Waldenburgertal plus;8;VR Waldenburgertal plus;1485;26;10;16;104;94;10;0;26;1511
1999;2894;Titterten;1305;Bezirk Waldenburg;10;VR Waldenburgertal plus;8;VR Waldenburgertal plus;403;3;3;0;19;19;0;0;0;403
1999;2895;Waldenburg;1305;Bezirk Waldenburg;10;VR Waldenburgertal plus;8;VR Waldenburgertal plus;1417;17;10;7;99;137;-38;0;-31;1386
2000;2761;Aesch (BL);1301;Bezirk Arlesheim;3;VR Alter Birsstadt;3;VR Alter Birsstadt;10106;91;57;34;738;860;-122;0;-88;10018
2000;2762;Allschwil;1301;Bezirk Arlesheim;1;VR Alter und Gesundheit ABS;1;VR Alter und Gesundheit ABS;18440;149;152;-3;1094;1283;-189;0;-192;18248
2000;2763;Arlesheim;1301;Bezirk Arlesheim;3;VR Alter Birsstadt;3;VR Alter Birsstadt;8534;80;78;2;694;621;73;-1;74;8608
2000;2764;Biel-Benken;1301;Bezirk Arlesheim;4;VR BPA Leimental;4;VR BPA Leimental;2709;28;12;16;185;150;35;0;51;2760
2000;2765;Binningen;1301;Bezirk Arlesheim;1;VR Alter und Gesundheit ABS;1;VR Alter und Gesundheit ABS;13950;114;126;-12;918;1008;-90;0;-102;13848
2000;2766;Birsfelden;1301;Bezirk Arlesheim;2;VR APG Rheintal;2;VR APG Rheintal;10892;72;108;-36;707;814;-107;-344;-487;10405
2000;2767;Bottmingen;1301;Bezirk Arlesheim;4;VR BPA Leimental;4;VR BPA Leimental;5541;29;34;-5;463;515;-52;0;-57;5484
2000;2768;Ettingen;1301;Bezirk Arlesheim;4;VR BPA Leimental;4;VR BPA Leimental;4803;50;31;19;390;345;45;1;65;4868
2000;2769;Münchenstein;1301;Bezirk Arlesheim;3;VR Alter Birsstadt;3;VR Alter Birsstadt;11638;98;131;-33;829;805;24;1;-8;11630
2000;2770;Muttenz;1301;Bezirk Arlesheim;2;VR APG Rheintal;2;VR APG Rheintal;16725;140;150;-10;896;976;-80;0;-90;16635
2000;2771;Oberwil (BL);1301;Bezirk Arlesheim;4;VR BPA Leimental;4;VR BPA Leimental;9423;87;62;25;699;760;-61;0;-36;9387
2000;2772;Pfeffingen;1301;Bezirk Arlesheim;3;VR Alter Birsstadt;3;VR Alter Birsstadt;2051;12;7;5;164;123;41;0;46;2097
2000;2773;Reinach (BL);1301;Bezirk Arlesheim;3;VR Alter Birsstadt;3;VR Alter Birsstadt;18336;147;93;54;1507;1208;299;0;353;18689
2000;2774;Schönenbuch;1301;Bezirk Arlesheim;1;VR Alter und Gesundheit ABS;1;VR Alter und Gesundheit ABS;1243;10;6;4;100;72;28;1;33;1276
2000;2775;Therwil;1301;Bezirk Arlesheim;4;VR BPA Leimental;4;VR BPA Leimental;8361;69;41;28;562;431;131;0;159;8520
2000;2781;Blauen;1302;Bezirk Laufen;5;VR APG Laufental;5;VR APG Laufental;662;2;6;-4;23;23;0;0;-4;658
2000;2782;Brislach;1302;Bezirk Laufen;5;VR APG Laufental;5;VR APG Laufental;1391;17;8;9;102;86;16;0;25;1416
2000;2783;Burg im Leimental;1302;Bezirk Laufen;4;VR BPA Leimental;4;VR BPA Leimental;241;2;3;-1;29;29;0;0;-1;240
2000;2784;Dittingen;1302;Bezirk Laufen;5;VR APG Laufental;5;VR APG Laufental;730;6;4;2;54;62;-8;0;-6;724
2000;2785;Duggingen;1302;Bezirk Laufen;3;VR Alter Birsstadt;3;VR Alter Birsstadt;1183;12;7;5;106;97;9;0;14;1197
2000;2786;Grellingen;1302;Bezirk Laufen;5;VR APG Laufental;5;VR APG Laufental;1644;11;12;-1;150;133;17;2;18;1662
2000;2787;Laufen;1302;Bezirk Laufen;5;VR APG Laufental;5;VR APG Laufental;4918;45;48;-3;309;285;24;1;22;4940
2000;2788;Liesberg;1302;Bezirk Laufen;5;VR APG Laufental;5;VR APG Laufental;1203;6;15;-9;35;48;-13;0;-22;1181
2000;2789;Nenzlingen;1302;Bezirk Laufen;5;VR APG Laufental;5;VR APG Laufental;349;5;2;3;6;3;3;0;6;355
2000;2790;Roggenburg;1302;Bezirk Laufen;5;VR APG Laufental;5;VR APG Laufental;250;5;7;-2;16;12;4;0;2;252
2000;2791;Röschenz;1302;Bezirk Laufen;5;VR APG Laufental;5;VR APG Laufental;1589;21;10;11;149;87;62;0;73;1662
2000;2792;Wahlen;1302;Bezirk Laufen;5;VR APG Laufental;5;VR APG Laufental;1227;15;9;6;96;63;33;0;39;1266
2000;2793;Zwingen;1302;Bezirk Laufen;5;VR APG Laufental;5;VR APG Laufental;2022;24;15;9;211;214;-3;0;6;2028
2000;2821;Arisdorf;1303;Bezirk Liestal;6;VR Alters- und Pflegeregion Liestal;6;VR Alters- und Pflegeregion Liestal;1396;23;9;14;87;95;-8;0;6;1402
2000;2822;Augst;1303;Bezirk Liestal;2;VR APG Rheintal;2;VR APG Rheintal;811;9;10;-1;247;98;149;0;148;959
2000;2823;Bubendorf;1303;Bezirk Liestal;6;VR Alters- und Pflegeregion Liestal;6;VR Alters- und Pflegeregion Liestal;4369;45;27;18;277;301;-24;0;-6;4363
2000;2824;Frenkendorf;1303;Bezirk Liestal;6;VR Alters- und Pflegeregion Liestal;6;VR Alters- und Pflegeregion Liestal;5906;58;31;27;523;497;26;1;54;5960
2000;2825;Füllinsdorf;1303;Bezirk Liestal;6;VR Alters- und Pflegeregion Liestal;6;VR Alters- und Pflegeregion Liestal;4138;31;21;10;356;350;6;1;17;4155
2000;2826;Giebenach;1303;Bezirk Liestal;2;VR APG Rheintal;2;VR APG Rheintal;826;4;1;3;68;88;-20;0;-17;809
2000;2827;Hersberg;1303;Bezirk Liestal;6;VR Alters- und Pflegeregion Liestal;6;VR Alters- und Pflegeregion Liestal;260;4;1;3;19;10;9;0;12;272
2000;2828;Lausen;1303;Bezirk Liestal;6;VR Alters- und Pflegeregion Liestal;6;VR Alters- und Pflegeregion Liestal;4621;47;29;18;488;427;61;0;79;4700
2000;2829;Liestal;1303;Bezirk Liestal;6;VR Alters- und Pflegeregion Liestal;6;VR Alters- und Pflegeregion Liestal;12748;134;89;45;1118;1019;99;0;144;12892
2000;2830;Lupsingen;1303;Bezirk Liestal;6;VR Alters- und Pflegeregion Liestal;6;VR Alters- und Pflegeregion Liestal;1207;19;11;8;97;49;48;0;56;1263
2000;2831;Pratteln;1303;Bezirk Liestal;2;VR APG Rheintal;2;VR APG Rheintal;15198;159;127;32;1040;1091;-51;0;-19;15179
2000;2832;Ramlinsburg;1303;Bezirk Liestal;10;VR Waldenburgertal plus;8;VR Waldenburgertal plus;631;9;7;2;56;40;16;0;18;649
2000;2833;Seltisberg;1303;Bezirk Liestal;6;VR Alters- und Pflegeregion Liestal;6;VR Alters- und Pflegeregion Liestal;1202;6;5;1;116;70;46;0;47;1249
2000;2834;Ziefen;1303;Bezirk Liestal;6;VR Alters- und Pflegeregion Liestal;6;VR Alters- und Pflegeregion Liestal;1387;17;9;8;107;80;27;0;35;1422
2000;2841;Anwil;1304;Bezirk Sissach;9;VR Farnsberg plus;7;Planungsregion Oberbaselbiet;483;5;3;2;32;25;7;0;9;492
2000;2842;Böckten;1304;Bezirk Sissach;7;VR Oberbaselbiet;7;Planungsregion Oberbaselbiet;712;4;2;2;72;81;-9;-10;-17;695
2000;2843;Buckten;1304;Bezirk Sissach;8;VR Oberes Homburgertal;7;Planungsregion Oberbaselbiet;674;10;4;6;34;56;-22;0;-16;658
2000;2844;Buus;1304;Bezirk Sissach;9;VR Farnsberg plus;7;Planungsregion Oberbaselbiet;904;10;5;5;69;39;30;0;35;939
2000;2845;Diepflingen;1304;Bezirk Sissach;7;VR Oberbaselbiet;7;Planungsregion Oberbaselbiet;479;6;3;3;57;48;9;19;31;510
2000;2846;Gelterkinden;1304;Bezirk Sissach;7;VR Oberbaselbiet;7;Planungsregion Oberbaselbiet;5403;51;41;10;406;311;95;0;105;5508
2000;2847;Häfelfingen;1304;Bezirk Sissach;8;VR Oberes Homburgertal;7;Planungsregion Oberbaselbiet;253;6;2;4;22;6;16;0;20;273
2000;2848;Hemmiken;1304;Bezirk Sissach;9;VR Farnsberg plus;7;Planungsregion Oberbaselbiet;287;4;3;1;21;13;8;0;9;296
2000;2849;Itingen;1304;Bezirk Sissach;7;VR Oberbaselbiet;7;Planungsregion Oberbaselbiet;1644;19;14;5;145;135;10;0;15;1659
2000;2850;Känerkinden;1304;Bezirk Sissach;8;VR Oberes Homburgertal;7;Planungsregion Oberbaselbiet;497;5;3;2;22;25;-3;0;-1;496
2000;2851;Kilchberg (BL);1304;Bezirk Sissach;9;VR Farnsberg plus;7;Planungsregion Oberbaselbiet;109;0;0;0;4;3;1;0;1;110
2000;2852;Läufelfingen;1304;Bezirk Sissach;8;VR Oberes Homburgertal;7;Planungsregion Oberbaselbiet;1281;11;11;0;89;84;5;0;5;1286
2000;2853;Maisprach;1304;Bezirk Sissach;9;VR Farnsberg plus;7;Planungsregion Oberbaselbiet;891;8;2;6;71;78;-7;0;-1;890
2000;2854;Nusshof;1304;Bezirk Sissach;7;VR Oberbaselbiet;7;Planungsregion Oberbaselbiet;196;2;0;2;17;7;10;0;12;208
2000;2855;Oltingen;1304;Bezirk Sissach;9;VR Farnsberg plus;7;Planungsregion Oberbaselbiet;412;3;1;2;19;26;-7;0;-5;407
2000;2856;Ormalingen;1304;Bezirk Sissach;7;VR Oberbaselbiet;7;Planungsregion Oberbaselbiet;1896;25;14;11;139;173;-34;0;-23;1873
2000;2857;Rickenbach (BL);1304;Bezirk Sissach;9;VR Farnsberg plus;7;Planungsregion Oberbaselbiet;518;7;0;7;31;22;9;0;16;534
2000;2858;Rothenfluh;1304;Bezirk Sissach;9;VR Farnsberg plus;7;Planungsregion Oberbaselbiet;700;8;5;3;21;34;-13;0;-10;690
2000;2859;Rümlingen;1304;Bezirk Sissach;8;VR Oberes Homburgertal;7;Planungsregion Oberbaselbiet;338;3;4;-1;49;39;10;-12;-3;335
2000;2860;Rünenberg;1304;Bezirk Sissach;9;VR Farnsberg plus;7;Planungsregion Oberbaselbiet;737;10;4;6;32;35;-3;0;3;740
2000;2861;Sissach;1304;Bezirk Sissach;7;VR Oberbaselbiet;7;Planungsregion Oberbaselbiet;5359;53;35;18;530;498;32;1;51;5410
2000;2862;Tecknau;1304;Bezirk Sissach;7;VR Oberbaselbiet;7;Planungsregion Oberbaselbiet;884;6;5;1;49;50;-1;0;0;884
2000;2863;Tenniken;1304;Bezirk Sissach;7;VR Oberbaselbiet;7;Planungsregion Oberbaselbiet;938;7;9;-2;44;57;-13;0;-15;923
2000;2864;Thürnen;1304;Bezirk Sissach;7;VR Oberbaselbiet;7;Planungsregion Oberbaselbiet;1172;12;10;2;113;124;-11;0;-9;1163
2000;2865;Wenslingen;1304;Bezirk Sissach;7;VR Oberbaselbiet;7;Planungsregion Oberbaselbiet;652;7;3;4;41;37;4;0;8;660
2000;2866;Wintersingen;1304;Bezirk Sissach;9;VR Farnsberg plus;7;Planungsregion Oberbaselbiet;618;6;4;2;18;16;2;0;4;622
2000;2867;Wittinsburg;1304;Bezirk Sissach;7;VR Oberbaselbiet;7;Planungsregion Oberbaselbiet;344;3;2;1;15;14;1;0;2;346
2000;2868;Zeglingen;1304;Bezirk Sissach;9;VR Farnsberg plus;7;Planungsregion Oberbaselbiet;455;3;0;3;23;31;-8;0;-5;450
2000;2869;Zunzgen;1304;Bezirk Sissach;7;VR Oberbaselbiet;7;Planungsregion Oberbaselbiet;2465;18;13;5;134;139;-5;0;0;2465
2000;2881;Arboldswil;1305;Bezirk Waldenburg;10;VR Waldenburgertal plus;8;VR Waldenburgertal plus;508;5;7;-2;26;34;-8;0;-10;498
2000;2882;Bennwil;1305;Bezirk Waldenburg;10;VR Waldenburgertal plus;8;VR Waldenburgertal plus;617;9;4;5;55;52;3;0;8;625
2000;2883;Bretzwil;1305;Bezirk Waldenburg;10;VR Waldenburgertal plus;8;VR Waldenburgertal plus;729;3;4;-1;42;37;5;0;4;733
2000;2884;Diegten;1305;Bezirk Waldenburg;7;VR Oberbaselbiet;7;Planungsregion Oberbaselbiet;1384;15;5;10;119;127;-8;0;2;1386
2000;2885;Eptingen;1305;Bezirk Waldenburg;7;VR Oberbaselbiet;7;Planungsregion Oberbaselbiet;562;3;4;-1;52;40;12;0;11;573
2000;2886;Hölstein;1305;Bezirk Waldenburg;10;VR Waldenburgertal plus;8;VR Waldenburgertal plus;2097;20;14;6;223;187;36;0;42;2139
2000;2887;Lampenberg;1305;Bezirk Waldenburg;10;VR Waldenburgertal plus;8;VR Waldenburgertal plus;469;6;6;0;37;27;10;0;10;479
2000;2888;Langenbruck;1305;Bezirk Waldenburg;10;VR Waldenburgertal plus;8;VR Waldenburgertal plus;975;7;7;0;72;100;-28;0;-28;947
2000;2889;Lauwil;1305;Bezirk Waldenburg;10;VR Waldenburgertal plus;8;VR Waldenburgertal plus;320;3;5;-2;19;3;16;0;14;334
2000;2890;Liedertswil;1305;Bezirk Waldenburg;10;VR Waldenburgertal plus;8;VR Waldenburgertal plus;154;1;0;1;11;19;-8;1;-6;148
2000;2891;Niederdorf;1305;Bezirk Waldenburg;10;VR Waldenburgertal plus;8;VR Waldenburgertal plus;1762;33;16;17;140;135;5;0;22;1784
2000;2892;Oberdorf (BL);1305;Bezirk Waldenburg;10;VR Waldenburgertal plus;8;VR Waldenburgertal plus;2341;18;21;-3;182;182;0;0;-3;2338
2000;2893;Reigoldswil;1305;Bezirk Waldenburg;10;VR Waldenburgertal plus;8;VR Waldenburgertal plus;1511;15;16;-1;86;67;19;0;18;1529
2000;2894;Titterten;1305;Bezirk Waldenburg;10;VR Waldenburgertal plus;8;VR Waldenburgertal plus;403;5;4;1;26;16;10;0;11;414
2000;2895;Waldenburg;1305;Bezirk Waldenburg;10;VR Waldenburgertal plus;8;VR Waldenburgertal plus;1386;15;10;5;110;113;-3;0;2;1388
2001;2761;Aesch (BL);1301;Bezirk Arlesheim;3;VR Alter Birsstadt;3;VR Alter Birsstadt;10018;103;58;45;714;717;-3;-247;-205;9813
2001;2762;Allschwil;1301;Bezirk Arlesheim;1;VR Alter und Gesundheit ABS;1;VR Alter und Gesundheit ABS;18248;124;163;-39;927;1057;-130;46;-123;18125
2001;2763;Arlesheim;1301;Bezirk Arlesheim;3;VR Alter Birsstadt;3;VR Alter Birsstadt;8608;84;68;16;683;560;123;0;139;8747
2001;2764;Biel-Benken;1301;Bezirk Arlesheim;4;VR BPA Leimental;4;VR BPA Leimental;2760;27;13;14;269;198;71;0;85;2845
2001;2765;Binningen;1301;Bezirk Arlesheim;1;VR Alter und Gesundheit ABS;1;VR Alter und Gesundheit ABS;13848;115;157;-42;1108;1028;80;1;39;13887
2001;2766;Birsfelden;1301;Bezirk Arlesheim;2;VR APG Rheintal;2;VR APG Rheintal;10405;87;100;-13;661;714;-53;0;-66;10339
2001;2767;Bottmingen;1301;Bezirk Arlesheim;4;VR BPA Leimental;4;VR BPA Leimental;5484;30;35;-5;553;490;63;0;58;5542
2001;2768;Ettingen;1301;Bezirk Arlesheim;4;VR BPA Leimental;4;VR BPA Leimental;4868;39;20;19;330;333;-3;0;16;4884
2001;2769;Münchenstein;1301;Bezirk Arlesheim;3;VR Alter Birsstadt;3;VR Alter Birsstadt;11630;112;91;21;780;891;-111;0;-90;11540
2001;2770;Muttenz;1301;Bezirk Arlesheim;2;VR APG Rheintal;2;VR APG Rheintal;16635;120;130;-10;966;864;102;0;92;16727
2001;2771;Oberwil (BL);1301;Bezirk Arlesheim;4;VR BPA Leimental;4;VR BPA Leimental;9387;89;60;29;775;766;9;0;38;9425
2001;2772;Pfeffingen;1301;Bezirk Arlesheim;3;VR Alter Birsstadt;3;VR Alter Birsstadt;2097;15;8;7;118;100;18;0;25;2122
2001;2773;Reinach (BL);1301;Bezirk Arlesheim;3;VR Alter Birsstadt;3;VR Alter Birsstadt;18689;135;140;-5;1387;1304;83;1;79;18768
2001;2774;Schönenbuch;1301;Bezirk Arlesheim;1;VR Alter und Gesundheit ABS;1;VR Alter und Gesundheit ABS;1276;13;3;10;89;72;17;0;27;1303
2001;2775;Therwil;1301;Bezirk Arlesheim;4;VR BPA Leimental;4;VR BPA Leimental;8520;103;60;43;908;712;196;0;239;8759
2001;2781;Blauen;1302;Bezirk Laufen;5;VR APG Laufental;5;VR APG Laufental;658;6;2;4;38;31;7;0;11;669
2001;2782;Brislach;1302;Bezirk Laufen;5;VR APG Laufental;5;VR APG Laufental;1416;19;6;13;67;64;3;0;16;1432
2001;2783;Burg im Leimental;1302;Bezirk Laufen;4;VR BPA Leimental;4;VR BPA Leimental;240;4;3;1;21;16;5;0;6;246
2001;2784;Dittingen;1302;Bezirk Laufen;5;VR APG Laufental;5;VR APG Laufental;724;15;5;10;71;85;-14;0;-4;720
2001;2785;Duggingen;1302;Bezirk Laufen;3;VR Alter Birsstadt;3;VR Alter Birsstadt;1197;12;10;2;123;109;14;-12;4;1201
2001;2786;Grellingen;1302;Bezirk Laufen;5;VR APG Laufental;5;VR APG Laufental;1662;15;9;6;156;149;7;0;13;1675
2001;2787;Laufen;1302;Bezirk Laufen;5;VR APG Laufental;5;VR APG Laufental;4940;52;38;14;312;289;23;0;37;4977
2001;2788;Liesberg;1302;Bezirk Laufen;5;VR APG Laufental;5;VR APG Laufental;1181;11;11;0;70;47;23;0;23;1204
2001;2789;Nenzlingen;1302;Bezirk Laufen;5;VR APG Laufental;5;VR APG Laufental;355;3;0;3;30;23;7;0;10;365
2001;2790;Roggenburg;1302;Bezirk Laufen;5;VR APG Laufental;5;VR APG Laufental;252;4;2;2;14;10;4;0;6;258
2001;2791;Röschenz;1302;Bezirk Laufen;5;VR APG Laufental;5;VR APG Laufental;1662;22;14;8;90;66;24;0;32;1694
2001;2792;Wahlen;1302;Bezirk Laufen;5;VR APG Laufental;5;VR APG Laufental;1266;12;9;3;66;65;1;0;4;1270
2001;2793;Zwingen;1302;Bezirk Laufen;5;VR APG Laufental;5;VR APG Laufental;2028;29;20;9;199;188;11;0;20;2048
2001;2821;Arisdorf;1303;Bezirk Liestal;6;VR Alters- und Pflegeregion Liestal;6;VR Alters- und Pflegeregion Liestal;1402;10;11;-1;85;101;-16;0;-17;1385
2001;2822;Augst;1303;Bezirk Liestal;2;VR APG Rheintal;2;VR APG Rheintal;959;8;7;1;73;68;5;0;6;965
2001;2823;Bubendorf;1303;Bezirk Liestal;6;VR Alters- und Pflegeregion Liestal;6;VR Alters- und Pflegeregion Liestal;4363;41;24;17;285;278;7;0;24;4387
2001;2824;Frenkendorf;1303;Bezirk Liestal;6;VR Alters- und Pflegeregion Liestal;6;VR Alters- und Pflegeregion Liestal;5960;46;35;11;419;402;17;0;28;5988
2001;2825;Füllinsdorf;1303;Bezirk Liestal;6;VR Alters- und Pflegeregion Liestal;6;VR Alters- und Pflegeregion Liestal;4155;37;23;14;338;429;-91;47;-30;4125
2001;2826;Giebenach;1303;Bezirk Liestal;2;VR APG Rheintal;2;VR APG Rheintal;809;18;7;11;57;56;1;0;12;821
2001;2827;Hersberg;1303;Bezirk Liestal;6;VR Alters- und Pflegeregion Liestal;6;VR Alters- und Pflegeregion Liestal;272;3;2;1;9;7;2;0;3;275
2001;2828;Lausen;1303;Bezirk Liestal;6;VR Alters- und Pflegeregion Liestal;6;VR Alters- und Pflegeregion Liestal;4700;46;35;11;364;355;9;0;20;4720
2001;2829;Liestal;1303;Bezirk Liestal;6;VR Alters- und Pflegeregion Liestal;6;VR Alters- und Pflegeregion Liestal;12892;123;99;24;1161;1124;37;0;61;12953
2001;2830;Lupsingen;1303;Bezirk Liestal;6;VR Alters- und Pflegeregion Liestal;6;VR Alters- und Pflegeregion Liestal;1263;15;9;6;43;64;-21;0;-15;1248
2001;2831;Pratteln;1303;Bezirk Liestal;2;VR APG Rheintal;2;VR APG Rheintal;15179;151;124;27;973;1077;-104;0;-77;15102
2001;2832;Ramlinsburg;1303;Bezirk Liestal;10;VR Waldenburgertal plus;8;VR Waldenburgertal plus;649;6;3;3;35;25;10;0;13;662
2001;2833;Seltisberg;1303;Bezirk Liestal;6;VR Alters- und Pflegeregion Liestal;6;VR Alters- und Pflegeregion Liestal;1249;12;6;6;112;77;35;0;41;1290
2001;2834;Ziefen;1303;Bezirk Liestal;6;VR Alters- und Pflegeregion Liestal;6;VR Alters- und Pflegeregion Liestal;1422;6;8;-2;61;70;-9;0;-11;1411
2001;2841;Anwil;1304;Bezirk Sissach;9;VR Farnsberg plus;7;Planungsregion Oberbaselbiet;492;3;1;2;36;26;10;0;12;504
2001;2842;Böckten;1304;Bezirk Sissach;7;VR Oberbaselbiet;7;Planungsregion Oberbaselbiet;695;9;7;2;90;63;27;0;29;724
2001;2843;Buckten;1304;Bezirk Sissach;8;VR Oberes Homburgertal;7;Planungsregion Oberbaselbiet;658;5;5;0;48;42;6;0;6;664
2001;2844;Buus;1304;Bezirk Sissach;9;VR Farnsberg plus;7;Planungsregion Oberbaselbiet;939;11;5;6;38;14;24;0;30;969
2001;2845;Diepflingen;1304;Bezirk Sissach;7;VR Oberbaselbiet;7;Planungsregion Oberbaselbiet;510;7;3;4;47;41;6;0;10;520
2001;2846;Gelterkinden;1304;Bezirk Sissach;7;VR Oberbaselbiet;7;Planungsregion Oberbaselbiet;5508;47;47;0;293;278;15;1;16;5524
2001;2847;Häfelfingen;1304;Bezirk Sissach;8;VR Oberes Homburgertal;7;Planungsregion Oberbaselbiet;273;2;3;-1;6;16;-10;0;-11;262
2001;2848;Hemmiken;1304;Bezirk Sissach;9;VR Farnsberg plus;7;Planungsregion Oberbaselbiet;296;6;3;3;20;18;2;0;5;301
2001;2849;Itingen;1304;Bezirk Sissach;7;VR Oberbaselbiet;7;Planungsregion Oberbaselbiet;1659;9;11;-2;132;137;-5;0;-7;1652
2001;2850;Känerkinden;1304;Bezirk Sissach;8;VR Oberes Homburgertal;7;Planungsregion Oberbaselbiet;496;1;1;0;20;24;-4;0;-4;492
2001;2851;Kilchberg (BL);1304;Bezirk Sissach;9;VR Farnsberg plus;7;Planungsregion Oberbaselbiet;110;1;0;1;2;13;-11;0;-10;100
2001;2852;Läufelfingen;1304;Bezirk Sissach;8;VR Oberes Homburgertal;7;Planungsregion Oberbaselbiet;1286;11;10;1;66;69;-3;0;-2;1284
2001;2853;Maisprach;1304;Bezirk Sissach;9;VR Farnsberg plus;7;Planungsregion Oberbaselbiet;890;13;4;9;53;50;3;0;12;902
2001;2854;Nusshof;1304;Bezirk Sissach;7;VR Oberbaselbiet;7;Planungsregion Oberbaselbiet;208;1;2;-1;6;2;4;0;3;211
2001;2855;Oltingen;1304;Bezirk Sissach;9;VR Farnsberg plus;7;Planungsregion Oberbaselbiet;407;5;4;1;14;26;-12;0;-11;396
2001;2856;Ormalingen;1304;Bezirk Sissach;7;VR Oberbaselbiet;7;Planungsregion Oberbaselbiet;1873;23;10;13;108;148;-40;0;-27;1846
2001;2857;Rickenbach (BL);1304;Bezirk Sissach;9;VR Farnsberg plus;7;Planungsregion Oberbaselbiet;534;6;3;3;46;29;17;0;20;554
2001;2858;Rothenfluh;1304;Bezirk Sissach;9;VR Farnsberg plus;7;Planungsregion Oberbaselbiet;690;4;4;0;33;42;-9;0;-9;681
2001;2859;Rümlingen;1304;Bezirk Sissach;8;VR Oberes Homburgertal;7;Planungsregion Oberbaselbiet;335;3;4;-1;13;25;-12;0;-13;322
2001;2860;Rünenberg;1304;Bezirk Sissach;9;VR Farnsberg plus;7;Planungsregion Oberbaselbiet;740;8;7;1;57;37;20;-27;-6;734
2001;2861;Sissach;1304;Bezirk Sissach;7;VR Oberbaselbiet;7;Planungsregion Oberbaselbiet;5410;50;58;-8;454;374;80;0;72;5482
2001;2862;Tecknau;1304;Bezirk Sissach;7;VR Oberbaselbiet;7;Planungsregion Oberbaselbiet;884;8;8;0;54;54;0;0;0;884
2001;2863;Tenniken;1304;Bezirk Sissach;7;VR Oberbaselbiet;7;Planungsregion Oberbaselbiet;923;5;9;-4;65;53;12;0;8;931
2001;2864;Thürnen;1304;Bezirk Sissach;7;VR Oberbaselbiet;7;Planungsregion Oberbaselbiet;1163;11;6;5;143;114;29;0;34;1197
2001;2865;Wenslingen;1304;Bezirk Sissach;7;VR Oberbaselbiet;7;Planungsregion Oberbaselbiet;660;11;11;0;30;24;6;0;6;666
2001;2866;Wintersingen;1304;Bezirk Sissach;9;VR Farnsberg plus;7;Planungsregion Oberbaselbiet;622;4;5;-1;28;15;13;1;13;635
2001;2867;Wittinsburg;1304;Bezirk Sissach;7;VR Oberbaselbiet;7;Planungsregion Oberbaselbiet;346;5;3;2;30;12;18;0;20;366
2001;2868;Zeglingen;1304;Bezirk Sissach;9;VR Farnsberg plus;7;Planungsregion Oberbaselbiet;450;6;5;1;35;23;12;0;13;463
2001;2869;Zunzgen;1304;Bezirk Sissach;7;VR Oberbaselbiet;7;Planungsregion Oberbaselbiet;2465;11;19;-8;146;174;-28;0;-36;2429
2001;2881;Arboldswil;1305;Bezirk Waldenburg;10;VR Waldenburgertal plus;8;VR Waldenburgertal plus;498;5;5;0;19;20;-1;0;-1;497
2001;2882;Bennwil;1305;Bezirk Waldenburg;10;VR Waldenburgertal plus;8;VR Waldenburgertal plus;625;8;2;6;30;41;-11;0;-5;620
2001;2883;Bretzwil;1305;Bezirk Waldenburg;10;VR Waldenburgertal plus;8;VR Waldenburgertal plus;733;7;2;5;46;28;18;0;23;756
2001;2884;Diegten;1305;Bezirk Waldenburg;7;VR Oberbaselbiet;7;Planungsregion Oberbaselbiet;1386;20;14;6;118;96;22;0;28;1414
2001;2885;Eptingen;1305;Bezirk Waldenburg;7;VR Oberbaselbiet;7;Planungsregion Oberbaselbiet;573;6;2;4;35;42;-7;0;-3;570
2001;2886;Hölstein;1305;Bezirk Waldenburg;10;VR Waldenburgertal plus;8;VR Waldenburgertal plus;2139;21;8;13;144;136;8;0;21;2160
2001;2887;Lampenberg;1305;Bezirk Waldenburg;10;VR Waldenburgertal plus;8;VR Waldenburgertal plus;479;2;4;-2;21;24;-3;0;-5;474
2001;2888;Langenbruck;1305;Bezirk Waldenburg;10;VR Waldenburgertal plus;8;VR Waldenburgertal plus;947;9;6;3;106;71;35;0;38;985
2001;2889;Lauwil;1305;Bezirk Waldenburg;10;VR Waldenburgertal plus;8;VR Waldenburgertal plus;334;2;1;1;10;5;5;0;6;340
2001;2890;Liedertswil;1305;Bezirk Waldenburg;10;VR Waldenburgertal plus;8;VR Waldenburgertal plus;148;1;0;1;10;10;0;0;1;149
2001;2891;Niederdorf;1305;Bezirk Waldenburg;10;VR Waldenburgertal plus;8;VR Waldenburgertal plus;1784;21;11;10;132;131;1;0;11;1795
2001;2892;Oberdorf (BL);1305;Bezirk Waldenburg;10;VR Waldenburgertal plus;8;VR Waldenburgertal plus;2338;17;21;-4;152;151;1;0;-3;2335
2001;2893;Reigoldswil;1305;Bezirk Waldenburg;10;VR Waldenburgertal plus;8;VR Waldenburgertal plus;1529;21;24;-3;117;92;25;0;22;1551
2001;2894;Titterten;1305;Bezirk Waldenburg;10;VR Waldenburgertal plus;8;VR Waldenburgertal plus;414;2;3;-1;14;16;-2;0;-3;411
2001;2895;Waldenburg;1305;Bezirk Waldenburg;10;VR Waldenburgertal plus;8;VR Waldenburgertal plus;1388;8;18;-10;94;142;-48;-65;-123;1265
2002;2761;Aesch (BL);1301;Bezirk Arlesheim;3;VR Alter Birsstadt;3;VR Alter Birsstadt;9813;75;59;16;776;571;205;-41;180;9993
2002;2762;Allschwil;1301;Bezirk Arlesheim;1;VR Alter und Gesundheit ABS;1;VR Alter und Gesundheit ABS;18125;133;160;-27;1382;1223;159;250;382;18507
2002;2763;Arlesheim;1301;Bezirk Arlesheim;3;VR Alter Birsstadt;3;VR Alter Birsstadt;8747;83;62;21;603;599;4;172;197;8944
2002;2764;Biel-Benken;1301;Bezirk Arlesheim;4;VR BPA Leimental;4;VR BPA Leimental;2845;28;17;11;209;175;34;-87;-42;2803
2002;2765;Binningen;1301;Bezirk Arlesheim;1;VR Alter und Gesundheit ABS;1;VR Alter und Gesundheit ABS;13887;117;125;-8;1047;927;120;409;521;14408
2002;2766;Birsfelden;1301;Bezirk Arlesheim;2;VR APG Rheintal;2;VR APG Rheintal;10339;100;97;3;642;632;10;134;147;10486
2002;2767;Bottmingen;1301;Bezirk Arlesheim;4;VR BPA Leimental;4;VR BPA Leimental;5542;46;46;0;578;540;38;117;155;5697
2002;2768;Ettingen;1301;Bezirk Arlesheim;4;VR BPA Leimental;4;VR BPA Leimental;4884;51;28;23;363;344;19;-19;23;4907
2002;2769;Münchenstein;1301;Bezirk Arlesheim;3;VR Alter Birsstadt;3;VR Alter Birsstadt;11540;102;99;3;794;738;56;145;204;11744
2002;2770;Muttenz;1301;Bezirk Arlesheim;2;VR APG Rheintal;2;VR APG Rheintal;16727;115;159;-44;996;837;159;44;159;16886
2002;2771;Oberwil (BL);1301;Bezirk Arlesheim;4;VR BPA Leimental;4;VR BPA Leimental;9425;78;54;24;815;656;159;44;227;9652
2002;2772;Pfeffingen;1301;Bezirk Arlesheim;3;VR Alter Birsstadt;3;VR Alter Birsstadt;2122;17;8;9;121;107;14;-32;-9;2113
2002;2773;Reinach (BL);1301;Bezirk Arlesheim;3;VR Alter Birsstadt;3;VR Alter Birsstadt;18768;138;158;-20;1191;1044;147;-167;-40;18728
2002;2774;Schönenbuch;1301;Bezirk Arlesheim;1;VR Alter und Gesundheit ABS;1;VR Alter und Gesundheit ABS;1303;7;3;4;106;64;42;-25;21;1324
2002;2775;Therwil;1301;Bezirk Arlesheim;4;VR BPA Leimental;4;VR BPA Leimental;8759;72;42;30;587;511;76;-18;88;8847
2002;2781;Blauen;1302;Bezirk Laufen;5;VR APG Laufental;5;VR APG Laufental;669;4;3;1;24;21;3;-3;1;670
2002;2782;Brislach;1302;Bezirk Laufen;5;VR APG Laufental;5;VR APG Laufental;1432;16;3;13;94;77;17;1;31;1463
2002;2783;Burg im Leimental;1302;Bezirk Laufen;4;VR BPA Leimental;4;VR BPA Leimental;246;3;0;3;19;10;9;-1;11;257
2002;2784;Dittingen;1302;Bezirk Laufen;5;VR APG Laufental;5;VR APG Laufental;720;7;4;3;42;47;-5;-12;-14;706
2002;2785;Duggingen;1302;Bezirk Laufen;3;VR Alter Birsstadt;3;VR Alter Birsstadt;1201;7;4;3;106;75;31;8;42;1243
2002;2786;Grellingen;1302;Bezirk Laufen;5;VR APG Laufental;5;VR APG Laufental;1675;14;12;2;125;134;-9;-32;-39;1636
2002;2787;Laufen;1302;Bezirk Laufen;5;VR APG Laufental;5;VR APG Laufental;4977;36;38;-2;331;231;100;-36;62;5039
2002;2788;Liesberg;1302;Bezirk Laufen;5;VR APG Laufental;5;VR APG Laufental;1204;6;10;-4;63;65;-2;-19;-25;1179
2002;2789;Nenzlingen;1302;Bezirk Laufen;5;VR APG Laufental;5;VR APG Laufental;365;5;1;4;23;9;14;-6;12;377
2002;2790;Roggenburg;1302;Bezirk Laufen;5;VR APG Laufental;5;VR APG Laufental;258;3;0;3;14;12;2;-9;-4;254
2002;2791;Röschenz;1302;Bezirk Laufen;5;VR APG Laufental;5;VR APG Laufental;1694;13;15;-2;137;102;35;-32;1;1695
2002;2792;Wahlen;1302;Bezirk Laufen;5;VR APG Laufental;5;VR APG Laufental;1270;9;7;2;81;68;13;-1;14;1284
2002;2793;Zwingen;1302;Bezirk Laufen;5;VR APG Laufental;5;VR APG Laufental;2048;23;6;17;159;165;-6;-17;-6;2042
2002;2821;Arisdorf;1303;Bezirk Liestal;6;VR Alters- und Pflegeregion Liestal;6;VR Alters- und Pflegeregion Liestal;1385;17;6;11;114;84;30;-18;23;1408
2002;2822;Augst;1303;Bezirk Liestal;2;VR APG Rheintal;2;VR APG Rheintal;965;9;7;2;69;76;-7;-6;-11;954
2002;2823;Bubendorf;1303;Bezirk Liestal;6;VR Alters- und Pflegeregion Liestal;6;VR Alters- und Pflegeregion Liestal;4387;32;18;14;256;260;-4;-6;4;4391
2002;2824;Frenkendorf;1303;Bezirk Liestal;6;VR Alters- und Pflegeregion Liestal;6;VR Alters- und Pflegeregion Liestal;5988;54;53;1;452;393;59;-107;-47;5941
2002;2825;Füllinsdorf;1303;Bezirk Liestal;6;VR Alters- und Pflegeregion Liestal;6;VR Alters- und Pflegeregion Liestal;4125;35;29;6;342;291;51;43;100;4225
2002;2826;Giebenach;1303;Bezirk Liestal;2;VR APG Rheintal;2;VR APG Rheintal;821;6;1;5;68;69;-1;-20;-16;805
2002;2827;Hersberg;1303;Bezirk Liestal;6;VR Alters- und Pflegeregion Liestal;6;VR Alters- und Pflegeregion Liestal;275;2;2;0;18;19;-1;-8;-9;266
2002;2828;Lausen;1303;Bezirk Liestal;6;VR Alters- und Pflegeregion Liestal;6;VR Alters- und Pflegeregion Liestal;4720;44;38;6;387;278;109;-1;114;4834
2002;2829;Liestal;1303;Bezirk Liestal;6;VR Alters- und Pflegeregion Liestal;6;VR Alters- und Pflegeregion Liestal;12953;142;119;23;1137;1030;107;-266;-136;12817
2002;2830;Lupsingen;1303;Bezirk Liestal;6;VR Alters- und Pflegeregion Liestal;6;VR Alters- und Pflegeregion Liestal;1248;11;6;5;62;65;-3;15;17;1265
2002;2831;Pratteln;1303;Bezirk Liestal;2;VR APG Rheintal;2;VR APG Rheintal;15102;143;129;14;987;863;124;-147;-9;15093
2002;2832;Ramlinsburg;1303;Bezirk Liestal;10;VR Waldenburgertal plus;8;VR Waldenburgertal plus;662;9;3;6;53;36;17;3;26;688
2002;2833;Seltisberg;1303;Bezirk Liestal;6;VR Alters- und Pflegeregion Liestal;6;VR Alters- und Pflegeregion Liestal;1290;5;8;-3;90;66;24;-16;5;1295
2002;2834;Ziefen;1303;Bezirk Liestal;6;VR Alters- und Pflegeregion Liestal;6;VR Alters- und Pflegeregion Liestal;1411;18;10;8;90;59;31;-36;3;1414
2002;2841;Anwil;1304;Bezirk Sissach;9;VR Farnsberg plus;7;Planungsregion Oberbaselbiet;504;3;4;-1;27;14;13;-2;10;514
2002;2842;Böckten;1304;Bezirk Sissach;7;VR Oberbaselbiet;7;Planungsregion Oberbaselbiet;724;6;8;-2;73;49;24;-21;1;725
2002;2843;Buckten;1304;Bezirk Sissach;8;VR Oberes Homburgertal;7;Planungsregion Oberbaselbiet;664;7;6;1;55;34;21;-14;8;672
2002;2844;Buus;1304;Bezirk Sissach;9;VR Farnsberg plus;7;Planungsregion Oberbaselbiet;969;5;5;0;63;56;7;-14;-7;962
2002;2845;Diepflingen;1304;Bezirk Sissach;7;VR Oberbaselbiet;7;Planungsregion Oberbaselbiet;520;6;6;0;30;35;-5;-5;-10;510
2002;2846;Gelterkinden;1304;Bezirk Sissach;7;VR Oberbaselbiet;7;Planungsregion Oberbaselbiet;5524;51;44;7;336;305;31;-67;-29;5495
2002;2847;Häfelfingen;1304;Bezirk Sissach;8;VR Oberes Homburgertal;7;Planungsregion Oberbaselbiet;262;3;4;-1;10;1;9;2;10;272
2002;2848;Hemmiken;1304;Bezirk Sissach;9;VR Farnsberg plus;7;Planungsregion Oberbaselbiet;301;2;1;1;22;22;0;-8;-7;294
2002;2849;Itingen;1304;Bezirk Sissach;7;VR Oberbaselbiet;7;Planungsregion Oberbaselbiet;1652;21;10;11;139;114;25;-18;18;1670
2002;2850;Känerkinden;1304;Bezirk Sissach;8;VR Oberes Homburgertal;7;Planungsregion Oberbaselbiet;492;7;5;2;21;17;4;-6;0;492
2002;2851;Kilchberg (BL);1304;Bezirk Sissach;9;VR Farnsberg plus;7;Planungsregion Oberbaselbiet;100;0;1;-1;10;3;7;-3;3;103
2002;2852;Läufelfingen;1304;Bezirk Sissach;8;VR Oberes Homburgertal;7;Planungsregion Oberbaselbiet;1284;8;9;-1;61;47;14;-47;-34;1250
2002;2853;Maisprach;1304;Bezirk Sissach;9;VR Farnsberg plus;7;Planungsregion Oberbaselbiet;902;5;6;-1;50;34;16;-8;7;909
2002;2854;Nusshof;1304;Bezirk Sissach;7;VR Oberbaselbiet;7;Planungsregion Oberbaselbiet;211;0;0;0;8;20;-12;-6;-18;193
2002;2855;Oltingen;1304;Bezirk Sissach;9;VR Farnsberg plus;7;Planungsregion Oberbaselbiet;396;3;3;0;31;24;7;0;7;403
2002;2856;Ormalingen;1304;Bezirk Sissach;7;VR Oberbaselbiet;7;Planungsregion Oberbaselbiet;1846;9;16;-7;79;102;-23;-28;-58;1788
2002;2857;Rickenbach (BL);1304;Bezirk Sissach;9;VR Farnsberg plus;7;Planungsregion Oberbaselbiet;554;6;4;2;34;24;10;-2;10;564
2002;2858;Rothenfluh;1304;Bezirk Sissach;9;VR Farnsberg plus;7;Planungsregion Oberbaselbiet;681;7;7;0;31;35;-4;14;10;691
2002;2859;Rümlingen;1304;Bezirk Sissach;8;VR Oberes Homburgertal;7;Planungsregion Oberbaselbiet;322;1;7;-6;43;27;16;5;15;337
2002;2860;Rünenberg;1304;Bezirk Sissach;9;VR Farnsberg plus;7;Planungsregion Oberbaselbiet;734;9;4;5;32;31;1;-1;5;739
2002;2861;Sissach;1304;Bezirk Sissach;7;VR Oberbaselbiet;7;Planungsregion Oberbaselbiet;5482;55;41;14;519;331;188;-115;87;5569
2002;2862;Tecknau;1304;Bezirk Sissach;7;VR Oberbaselbiet;7;Planungsregion Oberbaselbiet;884;4;6;-2;38;54;-16;-16;-34;850
2002;2863;Tenniken;1304;Bezirk Sissach;7;VR Oberbaselbiet;7;Planungsregion Oberbaselbiet;931;4;6;-2;61;50;11;-10;-1;930
2002;2864;Thürnen;1304;Bezirk Sissach;7;VR Oberbaselbiet;7;Planungsregion Oberbaselbiet;1197;16;5;11;115;85;30;-21;20;1217
2002;2865;Wenslingen;1304;Bezirk Sissach;7;VR Oberbaselbiet;7;Planungsregion Oberbaselbiet;666;9;4;5;37;29;8;3;16;682
2002;2866;Wintersingen;1304;Bezirk Sissach;9;VR Farnsberg plus;7;Planungsregion Oberbaselbiet;635;6;3;3;20;24;-4;-25;-26;609
2002;2867;Wittinsburg;1304;Bezirk Sissach;7;VR Oberbaselbiet;7;Planungsregion Oberbaselbiet;366;7;6;1;39;14;25;-2;24;390
2002;2868;Zeglingen;1304;Bezirk Sissach;9;VR Farnsberg plus;7;Planungsregion Oberbaselbiet;463;6;6;0;36;20;16;-4;12;475
2002;2869;Zunzgen;1304;Bezirk Sissach;7;VR Oberbaselbiet;7;Planungsregion Oberbaselbiet;2429;16;17;-1;174;157;17;20;36;2465
2002;2881;Arboldswil;1305;Bezirk Waldenburg;10;VR Waldenburgertal plus;8;VR Waldenburgertal plus;497;5;1;4;19;14;5;-11;-2;495
2002;2882;Bennwil;1305;Bezirk Waldenburg;10;VR Waldenburgertal plus;8;VR Waldenburgertal plus;620;8;5;3;34;32;2;0;5;625
2002;2883;Bretzwil;1305;Bezirk Waldenburg;10;VR Waldenburgertal plus;8;VR Waldenburgertal plus;756;5;6;-1;41;26;15;3;17;773
2002;2884;Diegten;1305;Bezirk Waldenburg;7;VR Oberbaselbiet;7;Planungsregion Oberbaselbiet;1414;16;5;11;96;53;43;-1;53;1467
2002;2885;Eptingen;1305;Bezirk Waldenburg;7;VR Oberbaselbiet;7;Planungsregion Oberbaselbiet;570;4;2;2;25;18;7;-6;3;573
2002;2886;Hölstein;1305;Bezirk Waldenburg;10;VR Waldenburgertal plus;8;VR Waldenburgertal plus;2160;22;13;9;122;135;-13;-8;-12;2148
2002;2887;Lampenberg;1305;Bezirk Waldenburg;10;VR Waldenburgertal plus;8;VR Waldenburgertal plus;474;4;3;1;36;14;22;-17;6;480
2002;2888;Langenbruck;1305;Bezirk Waldenburg;10;VR Waldenburgertal plus;8;VR Waldenburgertal plus;985;6;7;-1;77;44;33;-21;11;996
2002;2889;Lauwil;1305;Bezirk Waldenburg;10;VR Waldenburgertal plus;8;VR Waldenburgertal plus;340;5;2;3;18;17;1;-12;-8;332
2002;2890;Liedertswil;1305;Bezirk Waldenburg;10;VR Waldenburgertal plus;8;VR Waldenburgertal plus;149;2;0;2;15;6;9;4;15;164
2002;2891;Niederdorf;1305;Bezirk Waldenburg;10;VR Waldenburgertal plus;8;VR Waldenburgertal plus;1795;11;9;2;123;107;16;13;31;1826
2002;2892;Oberdorf (BL);1305;Bezirk Waldenburg;10;VR Waldenburgertal plus;8;VR Waldenburgertal plus;2335;17;22;-5;156;141;15;-22;-12;2323
2002;2893;Reigoldswil;1305;Bezirk Waldenburg;10;VR Waldenburgertal plus;8;VR Waldenburgertal plus;1551;16;10;6;77;95;-18;-16;-28;1523
2002;2894;Titterten;1305;Bezirk Waldenburg;10;VR Waldenburgertal plus;8;VR Waldenburgertal plus;411;2;3;-1;11;16;-5;-5;-11;400
2002;2895;Waldenburg;1305;Bezirk Waldenburg;10;VR Waldenburgertal plus;8;VR Waldenburgertal plus;1265;12;9;3;112;101;11;1;15;1280
2003;2761;Aesch (BL);1301;Bezirk Arlesheim;3;VR Alter Birsstadt;3;VR Alter Birsstadt;9993;89;59;30;678;745;-67;26;-11;9982
2003;2762;Allschwil;1301;Bezirk Arlesheim;1;VR Alter und Gesundheit ABS;1;VR Alter und Gesundheit ABS;18507;150;180;-30;1304;1312;-8;-9;-47;18460
2003;2763;Arlesheim;1301;Bezirk Arlesheim;3;VR Alter Birsstadt;3;VR Alter Birsstadt;8944;73;90;-17;763;655;108;0;91;9035
2003;2764;Biel-Benken;1301;Bezirk Arlesheim;4;VR BPA Leimental;4;VR BPA Leimental;2803;29;15;14;291;232;59;-2;71;2874
2003;2765;Binningen;1301;Bezirk Arlesheim;1;VR Alter und Gesundheit ABS;1;VR Alter und Gesundheit ABS;14408;116;158;-42;1073;1088;-15;-17;-74;14334
2003;2766;Birsfelden;1301;Bezirk Arlesheim;2;VR APG Rheintal;2;VR APG Rheintal;10486;104;108;-4;675;690;-15;-49;-68;10418
2003;2767;Bottmingen;1301;Bezirk Arlesheim;4;VR BPA Leimental;4;VR BPA Leimental;5697;46;46;0;636;599;37;1;38;5735
2003;2768;Ettingen;1301;Bezirk Arlesheim;4;VR BPA Leimental;4;VR BPA Leimental;4907;49;23;26;339;360;-21;1;6;4913
2003;2769;Münchenstein;1301;Bezirk Arlesheim;3;VR Alter Birsstadt;3;VR Alter Birsstadt;11744;78;128;-50;843;811;32;-11;-29;11715
2003;2770;Muttenz;1301;Bezirk Arlesheim;2;VR APG Rheintal;2;VR APG Rheintal;16886;116;146;-30;1029;850;179;2;151;17037
2003;2771;Oberwil (BL);1301;Bezirk Arlesheim;4;VR BPA Leimental;4;VR BPA Leimental;9652;90;55;35;875;727;148;-10;173;9825
2003;2772;Pfeffingen;1301;Bezirk Arlesheim;3;VR Alter Birsstadt;3;VR Alter Birsstadt;2113;15;10;5;120;100;20;2;27;2140
2003;2773;Reinach (BL);1301;Bezirk Arlesheim;3;VR Alter Birsstadt;3;VR Alter Birsstadt;18728;134;140;-6;1123;1149;-26;-18;-50;18678
2003;2774;Schönenbuch;1301;Bezirk Arlesheim;1;VR Alter und Gesundheit ABS;1;VR Alter und Gesundheit ABS;1324;19;10;9;63;83;-20;-7;-18;1306
2003;2775;Therwil;1301;Bezirk Arlesheim;4;VR BPA Leimental;4;VR BPA Leimental;8847;77;56;21;920;682;238;-1;258;9105
2003;2781;Blauen;1302;Bezirk Laufen;5;VR APG Laufental;5;VR APG Laufental;670;4;6;-2;39;34;5;0;3;673
2003;2782;Brislach;1302;Bezirk Laufen;5;VR APG Laufental;5;VR APG Laufental;1463;18;14;4;88;94;-6;1;-1;1462
2003;2783;Burg im Leimental;1302;Bezirk Laufen;4;VR BPA Leimental;4;VR BPA Leimental;257;1;1;0;18;23;-5;-3;-8;249
2003;2784;Dittingen;1302;Bezirk Laufen;5;VR APG Laufental;5;VR APG Laufental;706;8;10;-2;46;59;-13;0;-15;691
2003;2785;Duggingen;1302;Bezirk Laufen;3;VR Alter Birsstadt;3;VR Alter Birsstadt;1243;19;6;13;94;104;-10;0;3;1246
2003;2786;Grellingen;1302;Bezirk Laufen;5;VR APG Laufental;5;VR APG Laufental;1636;12;8;4;169;124;45;3;52;1688
2003;2787;Laufen;1302;Bezirk Laufen;5;VR APG Laufental;5;VR APG Laufental;5039;40;42;-2;329;255;74;-15;57;5096
2003;2788;Liesberg;1302;Bezirk Laufen;5;VR APG Laufental;5;VR APG Laufental;1179;7;7;0;77;65;12;0;12;1191
2003;2789;Nenzlingen;1302;Bezirk Laufen;5;VR APG Laufental;5;VR APG Laufental;377;5;1;4;23;15;8;-4;8;385
2003;2790;Roggenburg;1302;Bezirk Laufen;5;VR APG Laufental;5;VR APG Laufental;254;2;3;-1;17;7;10;3;12;266
2003;2791;Röschenz;1302;Bezirk Laufen;5;VR APG Laufental;5;VR APG Laufental;1695;23;19;4;98;89;9;-2;11;1706
2003;2792;Wahlen;1302;Bezirk Laufen;5;VR APG Laufental;5;VR APG Laufental;1284;14;7;7;94;67;27;0;34;1318
2003;2793;Zwingen;1302;Bezirk Laufen;5;VR APG Laufental;5;VR APG Laufental;2042;23;18;5;227;181;46;-2;49;2091
2003;2821;Arisdorf;1303;Bezirk Liestal;6;VR Alters- und Pflegeregion Liestal;6;VR Alters- und Pflegeregion Liestal;1408;14;8;6;116;82;34;-1;39;1447
2003;2822;Augst;1303;Bezirk Liestal;2;VR APG Rheintal;2;VR APG Rheintal;954;4;14;-10;72;85;-13;0;-23;931
2003;2823;Bubendorf;1303;Bezirk Liestal;6;VR Alters- und Pflegeregion Liestal;6;VR Alters- und Pflegeregion Liestal;4391;44;23;21;295;278;17;-6;32;4423
2003;2824;Frenkendorf;1303;Bezirk Liestal;6;VR Alters- und Pflegeregion Liestal;6;VR Alters- und Pflegeregion Liestal;5941;58;52;6;532;460;72;1;79;6020
2003;2825;Füllinsdorf;1303;Bezirk Liestal;6;VR Alters- und Pflegeregion Liestal;6;VR Alters- und Pflegeregion Liestal;4225;36;32;4;431;366;65;-5;64;4289
2003;2826;Giebenach;1303;Bezirk Liestal;2;VR APG Rheintal;2;VR APG Rheintal;805;3;4;-1;68;77;-9;0;-10;795
2003;2827;Hersberg;1303;Bezirk Liestal;6;VR Alters- und Pflegeregion Liestal;6;VR Alters- und Pflegeregion Liestal;266;0;1;-1;18;16;2;-1;0;266
2003;2828;Lausen;1303;Bezirk Liestal;6;VR Alters- und Pflegeregion Liestal;6;VR Alters- und Pflegeregion Liestal;4834;43;24;19;324;349;-25;1;-5;4829
2003;2829;Liestal;1303;Bezirk Liestal;6;VR Alters- und Pflegeregion Liestal;6;VR Alters- und Pflegeregion Liestal;12817;141;106;35;1199;1084;115;-43;107;12924
2003;2830;Lupsingen;1303;Bezirk Liestal;6;VR Alters- und Pflegeregion Liestal;6;VR Alters- und Pflegeregion Liestal;1265;5;6;-1;93;71;22;-1;20;1285
2003;2831;Pratteln;1303;Bezirk Liestal;2;VR APG Rheintal;2;VR APG Rheintal;15093;146;125;21;902;991;-89;2;-66;15027
2003;2832;Ramlinsburg;1303;Bezirk Liestal;10;VR Waldenburgertal plus;8;VR Waldenburgertal plus;688;14;0;14;42;51;-9;0;5;693
2003;2833;Seltisberg;1303;Bezirk Liestal;6;VR Alters- und Pflegeregion Liestal;6;VR Alters- und Pflegeregion Liestal;1295;12;5;7;117;87;30;0;37;1332
2003;2834;Ziefen;1303;Bezirk Liestal;6;VR Alters- und Pflegeregion Liestal;6;VR Alters- und Pflegeregion Liestal;1414;16;9;7;98;92;6;0;13;1427
2003;2841;Anwil;1304;Bezirk Sissach;9;VR Farnsberg plus;7;Planungsregion Oberbaselbiet;514;6;3;3;46;37;9;-2;10;524
2003;2842;Böckten;1304;Bezirk Sissach;7;VR Oberbaselbiet;7;Planungsregion Oberbaselbiet;725;10;2;8;70;75;-5;1;4;729
2003;2843;Buckten;1304;Bezirk Sissach;8;VR Oberes Homburgertal;7;Planungsregion Oberbaselbiet;672;7;6;1;47;43;4;0;5;677
2003;2844;Buus;1304;Bezirk Sissach;9;VR Farnsberg plus;7;Planungsregion Oberbaselbiet;962;13;3;10;65;58;7;-2;15;977
2003;2845;Diepflingen;1304;Bezirk Sissach;7;VR Oberbaselbiet;7;Planungsregion Oberbaselbiet;510;8;3;5;42;36;6;0;11;521
2003;2846;Gelterkinden;1304;Bezirk Sissach;7;VR Oberbaselbiet;7;Planungsregion Oberbaselbiet;5495;39;50;-11;372;297;75;34;98;5593
2003;2847;Häfelfingen;1304;Bezirk Sissach;8;VR Oberes Homburgertal;7;Planungsregion Oberbaselbiet;272;3;3;0;11;5;6;0;6;278
2003;2848;Hemmiken;1304;Bezirk Sissach;9;VR Farnsberg plus;7;Planungsregion Oberbaselbiet;294;4;0;4;8;13;-5;1;0;294
2003;2849;Itingen;1304;Bezirk Sissach;7;VR Oberbaselbiet;7;Planungsregion Oberbaselbiet;1670;11;12;-1;176;132;44;-2;41;1711
2003;2850;Känerkinden;1304;Bezirk Sissach;8;VR Oberes Homburgertal;7;Planungsregion Oberbaselbiet;492;8;2;6;25;31;-6;-3;-3;489
2003;2851;Kilchberg (BL);1304;Bezirk Sissach;9;VR Farnsberg plus;7;Planungsregion Oberbaselbiet;103;3;1;2;8;11;-3;0;-1;102
2003;2852;Läufelfingen;1304;Bezirk Sissach;8;VR Oberes Homburgertal;7;Planungsregion Oberbaselbiet;1250;12;13;-1;71;66;5;0;4;1254
2003;2853;Maisprach;1304;Bezirk Sissach;9;VR Farnsberg plus;7;Planungsregion Oberbaselbiet;909;11;2;9;66;69;-3;0;6;915
2003;2854;Nusshof;1304;Bezirk Sissach;7;VR Oberbaselbiet;7;Planungsregion Oberbaselbiet;193;1;2;-1;11;6;5;0;4;197
2003;2855;Oltingen;1304;Bezirk Sissach;9;VR Farnsberg plus;7;Planungsregion Oberbaselbiet;403;7;7;0;24;19;5;-3;2;405
2003;2856;Ormalingen;1304;Bezirk Sissach;7;VR Oberbaselbiet;7;Planungsregion Oberbaselbiet;1788;10;13;-3;141;122;19;0;16;1804
2003;2857;Rickenbach (BL);1304;Bezirk Sissach;9;VR Farnsberg plus;7;Planungsregion Oberbaselbiet;564;4;5;-1;36;46;-10;-1;-12;552
2003;2858;Rothenfluh;1304;Bezirk Sissach;9;VR Farnsberg plus;7;Planungsregion Oberbaselbiet;691;7;5;2;45;31;14;-2;14;705
2003;2859;Rümlingen;1304;Bezirk Sissach;8;VR Oberes Homburgertal;7;Planungsregion Oberbaselbiet;337;5;2;3;40;35;5;0;8;345
2003;2860;Rünenberg;1304;Bezirk Sissach;9;VR Farnsberg plus;7;Planungsregion Oberbaselbiet;739;9;4;5;35;34;1;0;6;745
2003;2861;Sissach;1304;Bezirk Sissach;7;VR Oberbaselbiet;7;Planungsregion Oberbaselbiet;5569;68;51;17;544;458;86;-12;91;5660
2003;2862;Tecknau;1304;Bezirk Sissach;7;VR Oberbaselbiet;7;Planungsregion Oberbaselbiet;850;6;6;0;70;65;5;0;5;855
2003;2863;Tenniken;1304;Bezirk Sissach;7;VR Oberbaselbiet;7;Planungsregion Oberbaselbiet;930;8;4;4;40;68;-28;0;-24;906
2003;2864;Thürnen;1304;Bezirk Sissach;7;VR Oberbaselbiet;7;Planungsregion Oberbaselbiet;1217;7;3;4;105;119;-14;-3;-13;1204
2003;2865;Wenslingen;1304;Bezirk Sissach;7;VR Oberbaselbiet;7;Planungsregion Oberbaselbiet;682;5;9;-4;44;41;3;0;-1;681
2003;2866;Wintersingen;1304;Bezirk Sissach;9;VR Farnsberg plus;7;Planungsregion Oberbaselbiet;609;3;5;-2;19;12;7;0;5;614
2003;2867;Wittinsburg;1304;Bezirk Sissach;7;VR Oberbaselbiet;7;Planungsregion Oberbaselbiet;390;6;1;5;11;15;-4;0;1;391
2003;2868;Zeglingen;1304;Bezirk Sissach;9;VR Farnsberg plus;7;Planungsregion Oberbaselbiet;475;3;3;0;29;14;15;0;15;490
2003;2869;Zunzgen;1304;Bezirk Sissach;7;VR Oberbaselbiet;7;Planungsregion Oberbaselbiet;2465;26;10;16;225;172;53;-6;63;2528
2003;2881;Arboldswil;1305;Bezirk Waldenburg;10;VR Waldenburgertal plus;8;VR Waldenburgertal plus;495;4;5;-1;38;23;15;-2;12;507
2003;2882;Bennwil;1305;Bezirk Waldenburg;10;VR Waldenburgertal plus;8;VR Waldenburgertal plus;625;11;9;2;34;40;-6;0;-4;621
2003;2883;Bretzwil;1305;Bezirk Waldenburg;10;VR Waldenburgertal plus;8;VR Waldenburgertal plus;773;6;5;1;28;47;-19;0;-18;755
2003;2884;Diegten;1305;Bezirk Waldenburg;7;VR Oberbaselbiet;7;Planungsregion Oberbaselbiet;1467;22;11;11;119;82;37;1;49;1516
2003;2885;Eptingen;1305;Bezirk Waldenburg;7;VR Oberbaselbiet;7;Planungsregion Oberbaselbiet;573;2;6;-4;39;69;-30;-1;-35;538
2003;2886;Hölstein;1305;Bezirk Waldenburg;10;VR Waldenburgertal plus;8;VR Waldenburgertal plus;2148;20;13;7;193;170;23;0;30;2178
2003;2887;Lampenberg;1305;Bezirk Waldenburg;10;VR Waldenburgertal plus;8;VR Waldenburgertal plus;480;5;4;1;34;28;6;0;7;487
2003;2888;Langenbruck;1305;Bezirk Waldenburg;10;VR Waldenburgertal plus;8;VR Waldenburgertal plus;996;9;3;6;81;74;7;-2;11;1007
2003;2889;Lauwil;1305;Bezirk Waldenburg;10;VR Waldenburgertal plus;8;VR Waldenburgertal plus;332;3;5;-2;17;12;5;-3;0;332
2003;2890;Liedertswil;1305;Bezirk Waldenburg;10;VR Waldenburgertal plus;8;VR Waldenburgertal plus;164;3;1;2;8;16;-8;0;-6;158
2003;2891;Niederdorf;1305;Bezirk Waldenburg;10;VR Waldenburgertal plus;8;VR Waldenburgertal plus;1826;19;13;6;113;132;-19;0;-13;1813
2003;2892;Oberdorf (BL);1305;Bezirk Waldenburg;10;VR Waldenburgertal plus;8;VR Waldenburgertal plus;2323;13;17;-4;133;161;-28;-7;-39;2284
2003;2893;Reigoldswil;1305;Bezirk Waldenburg;10;VR Waldenburgertal plus;8;VR Waldenburgertal plus;1523;15;18;-3;91;88;3;-6;-6;1517
2003;2894;Titterten;1305;Bezirk Waldenburg;10;VR Waldenburgertal plus;8;VR Waldenburgertal plus;400;4;4;0;41;27;14;-1;13;413
2003;2895;Waldenburg;1305;Bezirk Waldenburg;10;VR Waldenburgertal plus;8;VR Waldenburgertal plus;1280;15;12;3;104;85;19;0;22;1302
2004;2761;Aesch (BL);1301;Bezirk Arlesheim;3;VR Alter Birsstadt;3;VR Alter Birsstadt;9982;76;63;13;706;716;-10;-1;2;9984
2004;2762;Allschwil;1301;Bezirk Arlesheim;1;VR Alter und Gesundheit ABS;1;VR Alter und Gesundheit ABS;18460;154;159;-5;1280;1383;-103;-1;-109;18351
2004;2763;Arlesheim;1301;Bezirk Arlesheim;3;VR Alter Birsstadt;3;VR Alter Birsstadt;9035;79;84;-5;638;690;-52;-1;-58;8977
2004;2764;Biel-Benken;1301;Bezirk Arlesheim;4;VR BPA Leimental;4;VR BPA Leimental;2874;25;13;12;220;221;-1;0;11;2885
2004;2765;Binningen;1301;Bezirk Arlesheim;1;VR Alter und Gesundheit ABS;1;VR Alter und Gesundheit ABS;14334;131;135;-4;1086;1048;38;-4;30;14364
2004;2766;Birsfelden;1301;Bezirk Arlesheim;2;VR APG Rheintal;2;VR APG Rheintal;10418;80;111;-31;750;754;-4;-4;-39;10379
2004;2767;Bottmingen;1301;Bezirk Arlesheim;4;VR BPA Leimental;4;VR BPA Leimental;5735;43;38;5;630;642;-12;-3;-10;5725
2004;2768;Ettingen;1301;Bezirk Arlesheim;4;VR BPA Leimental;4;VR BPA Leimental;4913;57;29;28;307;328;-21;0;7;4920
2004;2769;Münchenstein;1301;Bezirk Arlesheim;3;VR Alter Birsstadt;3;VR Alter Birsstadt;11715;89;116;-27;929;864;65;-2;36;11751
2004;2770;Muttenz;1301;Bezirk Arlesheim;2;VR APG Rheintal;2;VR APG Rheintal;17037;129;157;-28;957;984;-27;-2;-57;16980
2004;2771;Oberwil (BL);1301;Bezirk Arlesheim;4;VR BPA Leimental;4;VR BPA Leimental;9825;74;64;10;768;726;42;0;52;9877
2004;2772;Pfeffingen;1301;Bezirk Arlesheim;3;VR Alter Birsstadt;3;VR Alter Birsstadt;2140;18;6;12;95;121;-26;0;-14;2126
2004;2773;Reinach (BL);1301;Bezirk Arlesheim;3;VR Alter Birsstadt;3;VR Alter Birsstadt;18678;135;120;15;1185;1167;18;-5;28;18706
2004;2774;Schönenbuch;1301;Bezirk Arlesheim;1;VR Alter und Gesundheit ABS;1;VR Alter und Gesundheit ABS;1306;13;3;10;118;66;52;0;62;1368
2004;2775;Therwil;1301;Bezirk Arlesheim;4;VR BPA Leimental;4;VR BPA Leimental;9105;80;45;35;689;636;53;0;88;9193
2004;2781;Blauen;1302;Bezirk Laufen;5;VR APG Laufental;5;VR APG Laufental;673;7;5;2;33;29;4;0;6;679
2004;2782;Brislach;1302;Bezirk Laufen;5;VR APG Laufental;5;VR APG Laufental;1462;24;11;13;93;100;-7;0;6;1468
2004;2783;Burg im Leimental;1302;Bezirk Laufen;4;VR BPA Leimental;4;VR BPA Leimental;249;2;4;-2;16;26;-10;0;-12;237
2004;2784;Dittingen;1302;Bezirk Laufen;5;VR APG Laufental;5;VR APG Laufental;691;8;12;-4;63;62;1;0;-3;688
2004;2785;Duggingen;1302;Bezirk Laufen;3;VR Alter Birsstadt;3;VR Alter Birsstadt;1246;10;5;5;86;88;-2;1;4;1250
2004;2786;Grellingen;1302;Bezirk Laufen;5;VR APG Laufental;5;VR APG Laufental;1688;16;16;0;165;148;17;-2;15;1703
2004;2787;Laufen;1302;Bezirk Laufen;5;VR APG Laufental;5;VR APG Laufental;5096;50;40;10;388;335;53;-1;62;5158
2004;2788;Liesberg;1302;Bezirk Laufen;5;VR APG Laufental;5;VR APG Laufental;1191;10;10;0;58;58;0;0;0;1191
2004;2789;Nenzlingen;1302;Bezirk Laufen;5;VR APG Laufental;5;VR APG Laufental;385;3;3;0;19;18;1;0;1;386
2004;2790;Roggenburg;1302;Bezirk Laufen;5;VR APG Laufental;5;VR APG Laufental;266;3;3;0;8;13;-5;0;-5;261
2004;2791;Röschenz;1302;Bezirk Laufen;5;VR APG Laufental;5;VR APG Laufental;1706;7;18;-11;117;95;22;0;11;1717
2004;2792;Wahlen;1302;Bezirk Laufen;5;VR APG Laufental;5;VR APG Laufental;1318;9;6;3;92;77;15;0;18;1336
2004;2793;Zwingen;1302;Bezirk Laufen;5;VR APG Laufental;5;VR APG Laufental;2091;22;15;7;187;169;18;0;25;2116
2004;2821;Arisdorf;1303;Bezirk Liestal;6;VR Alters- und Pflegeregion Liestal;6;VR Alters- und Pflegeregion Liestal;1447;10;10;0;73;77;-4;0;-4;1443
2004;2822;Augst;1303;Bezirk Liestal;2;VR APG Rheintal;2;VR APG Rheintal;931;7;11;-4;77;72;5;0;1;932
2004;2823;Bubendorf;1303;Bezirk Liestal;6;VR Alters- und Pflegeregion Liestal;6;VR Alters- und Pflegeregion Liestal;4423;27;24;3;261;289;-28;3;-22;4401
2004;2824;Frenkendorf;1303;Bezirk Liestal;6;VR Alters- und Pflegeregion Liestal;6;VR Alters- und Pflegeregion Liestal;6020;63;37;26;448;414;34;-3;57;6077
2004;2825;Füllinsdorf;1303;Bezirk Liestal;6;VR Alters- und Pflegeregion Liestal;6;VR Alters- und Pflegeregion Liestal;4289;48;28;20;374;319;55;0;75;4364
2004;2826;Giebenach;1303;Bezirk Liestal;2;VR APG Rheintal;2;VR APG Rheintal;795;4;0;4;90;54;36;0;40;835
2004;2827;Hersberg;1303;Bezirk Liestal;6;VR Alters- und Pflegeregion Liestal;6;VR Alters- und Pflegeregion Liestal;266;3;2;1;15;9;6;0;7;273
2004;2828;Lausen;1303;Bezirk Liestal;6;VR Alters- und Pflegeregion Liestal;6;VR Alters- und Pflegeregion Liestal;4829;53;27;26;366;388;-22;-1;3;4832
2004;2829;Liestal;1303;Bezirk Liestal;6;VR Alters- und Pflegeregion Liestal;6;VR Alters- und Pflegeregion Liestal;12924;126;98;28;1067;977;90;-6;112;13036
2004;2830;Lupsingen;1303;Bezirk Liestal;6;VR Alters- und Pflegeregion Liestal;6;VR Alters- und Pflegeregion Liestal;1285;14;4;10;70;67;3;1;14;1299
2004;2831;Pratteln;1303;Bezirk Liestal;2;VR APG Rheintal;2;VR APG Rheintal;15027;149;105;44;876;959;-83;0;-39;14988
2004;2832;Ramlinsburg;1303;Bezirk Liestal;10;VR Waldenburgertal plus;8;VR Waldenburgertal plus;693;6;3;3;44;43;1;0;4;697
2004;2833;Seltisberg;1303;Bezirk Liestal;6;VR Alters- und Pflegeregion Liestal;6;VR Alters- und Pflegeregion Liestal;1332;11;8;3;70;92;-22;0;-19;1313
2004;2834;Ziefen;1303;Bezirk Liestal;6;VR Alters- und Pflegeregion Liestal;6;VR Alters- und Pflegeregion Liestal;1427;12;14;-2;118;79;39;0;37;1464
2004;2841;Anwil;1304;Bezirk Sissach;9;VR Farnsberg plus;7;Planungsregion Oberbaselbiet;524;4;5;-1;29;28;1;0;0;524
2004;2842;Böckten;1304;Bezirk Sissach;7;VR Oberbaselbiet;7;Planungsregion Oberbaselbiet;729;16;8;8;49;41;8;0;16;745
2004;2843;Buckten;1304;Bezirk Sissach;8;VR Oberes Homburgertal;7;Planungsregion Oberbaselbiet;677;3;3;0;26;43;-17;0;-17;660
2004;2844;Buus;1304;Bezirk Sissach;9;VR Farnsberg plus;7;Planungsregion Oberbaselbiet;977;11;6;5;37;31;6;0;11;988
2004;2845;Diepflingen;1304;Bezirk Sissach;7;VR Oberbaselbiet;7;Planungsregion Oberbaselbiet;521;11;3;8;31;32;-1;0;7;528
2004;2846;Gelterkinden;1304;Bezirk Sissach;7;VR Oberbaselbiet;7;Planungsregion Oberbaselbiet;5593;37;48;-11;319;319;0;-1;-12;5581
2004;2847;Häfelfingen;1304;Bezirk Sissach;8;VR Oberes Homburgertal;7;Planungsregion Oberbaselbiet;278;2;2;0;11;17;-6;0;-6;272
2004;2848;Hemmiken;1304;Bezirk Sissach;9;VR Farnsberg plus;7;Planungsregion Oberbaselbiet;294;4;4;0;11;21;-10;0;-10;284
2004;2849;Itingen;1304;Bezirk Sissach;7;VR Oberbaselbiet;7;Planungsregion Oberbaselbiet;1711;16;10;6;176;170;6;0;12;1723
2004;2850;Känerkinden;1304;Bezirk Sissach;8;VR Oberes Homburgertal;7;Planungsregion Oberbaselbiet;489;5;2;3;47;29;18;-2;19;508
2004;2851;Kilchberg (BL);1304;Bezirk Sissach;9;VR Farnsberg plus;7;Planungsregion Oberbaselbiet;102;0;1;-1;11;5;6;0;5;107
2004;2852;Läufelfingen;1304;Bezirk Sissach;8;VR Oberes Homburgertal;7;Planungsregion Oberbaselbiet;1254;7;10;-3;83;64;19;0;16;1270
2004;2853;Maisprach;1304;Bezirk Sissach;9;VR Farnsberg plus;7;Planungsregion Oberbaselbiet;915;9;9;0;49;46;3;0;3;918
2004;2854;Nusshof;1304;Bezirk Sissach;7;VR Oberbaselbiet;7;Planungsregion Oberbaselbiet;197;1;3;-2;13;11;2;0;0;197
2004;2855;Oltingen;1304;Bezirk Sissach;9;VR Farnsberg plus;7;Planungsregion Oberbaselbiet;405;5;3;2;18;19;-1;0;1;406
2004;2856;Ormalingen;1304;Bezirk Sissach;7;VR Oberbaselbiet;7;Planungsregion Oberbaselbiet;1804;11;11;0;137;113;24;0;24;1828
2004;2857;Rickenbach (BL);1304;Bezirk Sissach;9;VR Farnsberg plus;7;Planungsregion Oberbaselbiet;552;8;2;6;43;28;15;0;21;573
2004;2858;Rothenfluh;1304;Bezirk Sissach;9;VR Farnsberg plus;7;Planungsregion Oberbaselbiet;705;6;5;1;41;39;2;0;3;708
2004;2859;Rümlingen;1304;Bezirk Sissach;8;VR Oberes Homburgertal;7;Planungsregion Oberbaselbiet;345;4;5;-1;48;45;3;-1;1;346
2004;2860;Rünenberg;1304;Bezirk Sissach;9;VR Farnsberg plus;7;Planungsregion Oberbaselbiet;745;6;5;1;39;26;13;0;14;759
2004;2861;Sissach;1304;Bezirk Sissach;7;VR Oberbaselbiet;7;Planungsregion Oberbaselbiet;5660;45;35;10;420;459;-39;-2;-31;5629
2004;2862;Tecknau;1304;Bezirk Sissach;7;VR Oberbaselbiet;7;Planungsregion Oberbaselbiet;855;10;5;5;61;61;0;0;5;860
2004;2863;Tenniken;1304;Bezirk Sissach;7;VR Oberbaselbiet;7;Planungsregion Oberbaselbiet;906;7;5;2;61;57;4;-1;5;911
2004;2864;Thürnen;1304;Bezirk Sissach;7;VR Oberbaselbiet;7;Planungsregion Oberbaselbiet;1204;9;5;4;135;105;30;0;34;1238
2004;2865;Wenslingen;1304;Bezirk Sissach;7;VR Oberbaselbiet;7;Planungsregion Oberbaselbiet;681;5;4;1;25;45;-20;0;-19;662
2004;2866;Wintersingen;1304;Bezirk Sissach;9;VR Farnsberg plus;7;Planungsregion Oberbaselbiet;614;4;8;-4;25;16;9;0;5;619
2004;2867;Wittinsburg;1304;Bezirk Sissach;7;VR Oberbaselbiet;7;Planungsregion Oberbaselbiet;391;7;1;6;50;30;20;0;26;417
2004;2868;Zeglingen;1304;Bezirk Sissach;9;VR Farnsberg plus;7;Planungsregion Oberbaselbiet;490;7;2;5;13;37;-24;0;-19;471
2004;2869;Zunzgen;1304;Bezirk Sissach;7;VR Oberbaselbiet;7;Planungsregion Oberbaselbiet;2528;24;12;12;149;172;-23;-1;-12;2516
2004;2881;Arboldswil;1305;Bezirk Waldenburg;10;VR Waldenburgertal plus;8;VR Waldenburgertal plus;507;6;3;3;23;24;-1;0;2;509
2004;2882;Bennwil;1305;Bezirk Waldenburg;10;VR Waldenburgertal plus;8;VR Waldenburgertal plus;621;8;3;5;29;30;-1;0;4;625
2004;2883;Bretzwil;1305;Bezirk Waldenburg;10;VR Waldenburgertal plus;8;VR Waldenburgertal plus;755;9;4;5;60;47;13;0;18;773
2004;2884;Diegten;1305;Bezirk Waldenburg;7;VR Oberbaselbiet;7;Planungsregion Oberbaselbiet;1516;19;4;15;87;100;-13;0;2;1518
2004;2885;Eptingen;1305;Bezirk Waldenburg;7;VR Oberbaselbiet;7;Planungsregion Oberbaselbiet;538;10;4;6;43;35;8;0;14;552
2004;2886;Hölstein;1305;Bezirk Waldenburg;10;VR Waldenburgertal plus;8;VR Waldenburgertal plus;2178;22;12;10;221;166;55;0;65;2243
2004;2887;Lampenberg;1305;Bezirk Waldenburg;10;VR Waldenburgertal plus;8;VR Waldenburgertal plus;487;4;5;-1;37;16;21;0;20;507
2004;2888;Langenbruck;1305;Bezirk Waldenburg;10;VR Waldenburgertal plus;8;VR Waldenburgertal plus;1007;5;13;-8;81;81;0;0;-8;999
2004;2889;Lauwil;1305;Bezirk Waldenburg;10;VR Waldenburgertal plus;8;VR Waldenburgertal plus;332;3;7;-4;20;19;1;0;-3;329
2004;2890;Liedertswil;1305;Bezirk Waldenburg;10;VR Waldenburgertal plus;8;VR Waldenburgertal plus;158;2;1;1;19;17;2;-1;2;160
2004;2891;Niederdorf;1305;Bezirk Waldenburg;10;VR Waldenburgertal plus;8;VR Waldenburgertal plus;1813;10;11;-1;110;123;-13;-1;-15;1798
2004;2892;Oberdorf (BL);1305;Bezirk Waldenburg;10;VR Waldenburgertal plus;8;VR Waldenburgertal plus;2284;15;16;-1;166;150;16;0;15;2299
2004;2893;Reigoldswil;1305;Bezirk Waldenburg;10;VR Waldenburgertal plus;8;VR Waldenburgertal plus;1517;14;15;-1;121;111;10;0;9;1526
2004;2894;Titterten;1305;Bezirk Waldenburg;10;VR Waldenburgertal plus;8;VR Waldenburgertal plus;413;3;4;-1;25;22;3;0;2;415
2004;2895;Waldenburg;1305;Bezirk Waldenburg;10;VR Waldenburgertal plus;8;VR Waldenburgertal plus;1302;19;11;8;130;133;-3;0;5;1307
2005;2761;Aesch (BL);1301;Bezirk Arlesheim;3;VR Alter Birsstadt;3;VR Alter Birsstadt;9984;75;66;9;648;712;-64;0;-55;9929
2005;2762;Allschwil;1301;Bezirk Arlesheim;1;VR Alter und Gesundheit ABS;1;VR Alter und Gesundheit ABS;18351;155;174;-19;1298;1276;22;0;3;18354
2005;2763;Arlesheim;1301;Bezirk Arlesheim;3;VR Alter Birsstadt;3;VR Alter Birsstadt;8977;77;81;-4;630;676;-46;0;-50;8927
2005;2764;Biel-Benken;1301;Bezirk Arlesheim;4;VR BPA Leimental;4;VR BPA Leimental;2885;30;19;11;241;220;21;0;32;2917
2005;2765;Binningen;1301;Bezirk Arlesheim;1;VR Alter und Gesundheit ABS;1;VR Alter und Gesundheit ABS;14364;122;132;-10;1166;1120;46;0;36;14400
2005;2766;Birsfelden;1301;Bezirk Arlesheim;2;VR APG Rheintal;2;VR APG Rheintal;10379;95;103;-8;747;753;-6;-1;-15;10364
2005;2767;Bottmingen;1301;Bezirk Arlesheim;4;VR BPA Leimental;4;VR BPA Leimental;5725;48;48;0;562;531;31;-1;30;5755
2005;2768;Ettingen;1301;Bezirk Arlesheim;4;VR BPA Leimental;4;VR BPA Leimental;4920;34;35;-1;254;329;-75;0;-76;4844
2005;2769;Münchenstein;1301;Bezirk Arlesheim;3;VR Alter Birsstadt;3;VR Alter Birsstadt;11751;81;121;-40;869;853;16;-1;-25;11726
2005;2770;Muttenz;1301;Bezirk Arlesheim;2;VR APG Rheintal;2;VR APG Rheintal;16980;128;168;-40;1006;978;28;0;-12;16968
2005;2771;Oberwil (BL);1301;Bezirk Arlesheim;4;VR BPA Leimental;4;VR BPA Leimental;9877;96;68;28;954;802;152;0;180;10057
2005;2772;Pfeffingen;1301;Bezirk Arlesheim;3;VR Alter Birsstadt;3;VR Alter Birsstadt;2126;17;11;6;136;103;33;0;39;2165
2005;2773;Reinach (BL);1301;Bezirk Arlesheim;3;VR Alter Birsstadt;3;VR Alter Birsstadt;18706;124;140;-16;1228;1225;3;0;-13;18693
2005;2774;Schönenbuch;1301;Bezirk Arlesheim;1;VR Alter und Gesundheit ABS;1;VR Alter und Gesundheit ABS;1368;8;5;3;98;59;39;0;42;1410
2005;2775;Therwil;1301;Bezirk Arlesheim;4;VR BPA Leimental;4;VR BPA Leimental;9193;87;57;30;703;581;122;0;152;9345
2005;2781;Blauen;1302;Bezirk Laufen;5;VR APG Laufental;5;VR APG Laufental;679;4;5;-1;39;37;2;0;1;680
2005;2782;Brislach;1302;Bezirk Laufen;5;VR APG Laufental;5;VR APG Laufental;1468;14;10;4;85;74;11;0;15;1483
2005;2783;Burg im Leimental;1302;Bezirk Laufen;4;VR BPA Leimental;4;VR BPA Leimental;237;4;2;2;21;12;9;0;11;248
2005;2784;Dittingen;1302;Bezirk Laufen;5;VR APG Laufental;5;VR APG Laufental;688;3;5;-2;62;53;9;-1;6;694
2005;2785;Duggingen;1302;Bezirk Laufen;3;VR Alter Birsstadt;3;VR Alter Birsstadt;1250;12;11;1;102;83;19;0;20;1270
2005;2786;Grellingen;1302;Bezirk Laufen;5;VR APG Laufental;5;VR APG Laufental;1703;20;10;10;131;125;6;0;16;1719
2005;2787;Laufen;1302;Bezirk Laufen;5;VR APG Laufental;5;VR APG Laufental;5158;38;45;-7;384;311;73;0;66;5224
2005;2788;Liesberg;1302;Bezirk Laufen;5;VR APG Laufental;5;VR APG Laufental;1191;6;9;-3;65;80;-15;0;-18;1173
2005;2789;Nenzlingen;1302;Bezirk Laufen;5;VR APG Laufental;5;VR APG Laufental;386;6;2;4;31;16;15;0;19;405
2005;2790;Roggenburg;1302;Bezirk Laufen;5;VR APG Laufental;5;VR APG Laufental;261;3;3;0;12;11;1;0;1;262
2005;2791;Röschenz;1302;Bezirk Laufen;5;VR APG Laufental;5;VR APG Laufental;1717;27;18;9;121;116;5;0;14;1731
2005;2792;Wahlen;1302;Bezirk Laufen;5;VR APG Laufental;5;VR APG Laufental;1336;12;11;1;85;99;-14;0;-13;1323
2005;2793;Zwingen;1302;Bezirk Laufen;5;VR APG Laufental;5;VR APG Laufental;2116;17;24;-7;136;177;-41;-4;-52;2064
2005;2821;Arisdorf;1303;Bezirk Liestal;6;VR Alters- und Pflegeregion Liestal;6;VR Alters- und Pflegeregion Liestal;1443;10;3;7;105;73;32;0;39;1482
2005;2822;Augst;1303;Bezirk Liestal;2;VR APG Rheintal;2;VR APG Rheintal;932;6;5;1;72;86;-14;0;-13;919
2005;2823;Bubendorf;1303;Bezirk Liestal;6;VR Alters- und Pflegeregion Liestal;6;VR Alters- und Pflegeregion Liestal;4401;36;24;12;217;237;-20;0;-8;4393
2005;2824;Frenkendorf;1303;Bezirk Liestal;6;VR Alters- und Pflegeregion Liestal;6;VR Alters- und Pflegeregion Liestal;6077;55;32;23;433;405;28;0;51;6128
2005;2825;Füllinsdorf;1303;Bezirk Liestal;6;VR Alters- und Pflegeregion Liestal;6;VR Alters- und Pflegeregion Liestal;4364;40;29;11;290;356;-66;0;-55;4309
2005;2826;Giebenach;1303;Bezirk Liestal;2;VR APG Rheintal;2;VR APG Rheintal;835;9;2;7;134;77;57;0;64;899
2005;2827;Hersberg;1303;Bezirk Liestal;6;VR Alters- und Pflegeregion Liestal;6;VR Alters- und Pflegeregion Liestal;273;2;1;1;20;24;-4;0;-3;270
2005;2828;Lausen;1303;Bezirk Liestal;6;VR Alters- und Pflegeregion Liestal;6;VR Alters- und Pflegeregion Liestal;4832;38;29;9;349;367;-18;0;-9;4823
2005;2829;Liestal;1303;Bezirk Liestal;6;VR Alters- und Pflegeregion Liestal;6;VR Alters- und Pflegeregion Liestal;13036;162;108;54;1115;992;123;0;177;13213
2005;2830;Lupsingen;1303;Bezirk Liestal;6;VR Alters- und Pflegeregion Liestal;6;VR Alters- und Pflegeregion Liestal;1299;10;10;0;82;86;-4;-1;-5;1294
2005;2831;Pratteln;1303;Bezirk Liestal;2;VR APG Rheintal;2;VR APG Rheintal;14988;151;127;24;903;938;-35;-1;-12;14976
2005;2832;Ramlinsburg;1303;Bezirk Liestal;10;VR Waldenburgertal plus;8;VR Waldenburgertal plus;697;6;4;2;53;50;3;0;5;702
2005;2833;Seltisberg;1303;Bezirk Liestal;6;VR Alters- und Pflegeregion Liestal;6;VR Alters- und Pflegeregion Liestal;1313;13;8;5;85;84;1;-1;5;1318
2005;2834;Ziefen;1303;Bezirk Liestal;6;VR Alters- und Pflegeregion Liestal;6;VR Alters- und Pflegeregion Liestal;1464;7;8;-1;62;63;-1;0;-2;1462
2005;2841;Anwil;1304;Bezirk Sissach;9;VR Farnsberg plus;7;Planungsregion Oberbaselbiet;524;4;5;-1;38;20;18;0;17;541
2005;2842;Böckten;1304;Bezirk Sissach;7;VR Oberbaselbiet;7;Planungsregion Oberbaselbiet;745;8;4;4;70;65;5;0;9;754
2005;2843;Buckten;1304;Bezirk Sissach;8;VR Oberes Homburgertal;7;Planungsregion Oberbaselbiet;660;5;3;2;55;45;10;0;12;672
2005;2844;Buus;1304;Bezirk Sissach;9;VR Farnsberg plus;7;Planungsregion Oberbaselbiet;988;5;6;-1;29;64;-35;0;-36;952
2005;2845;Diepflingen;1304;Bezirk Sissach;7;VR Oberbaselbiet;7;Planungsregion Oberbaselbiet;528;4;4;0;54;36;18;0;18;546
2005;2846;Gelterkinden;1304;Bezirk Sissach;7;VR Oberbaselbiet;7;Planungsregion Oberbaselbiet;5581;52;50;2;333;331;2;-1;3;5584
2005;2847;Häfelfingen;1304;Bezirk Sissach;8;VR Oberes Homburgertal;7;Planungsregion Oberbaselbiet;272;2;2;0;12;8;4;0;4;276
2005;2848;Hemmiken;1304;Bezirk Sissach;9;VR Farnsberg plus;7;Planungsregion Oberbaselbiet;284;2;2;0;18;26;-8;0;-8;276
2005;2849;Itingen;1304;Bezirk Sissach;7;VR Oberbaselbiet;7;Planungsregion Oberbaselbiet;1723;9;16;-7;221;128;93;0;86;1809
2005;2850;Känerkinden;1304;Bezirk Sissach;8;VR Oberes Homburgertal;7;Planungsregion Oberbaselbiet;508;2;3;-1;18;24;-6;0;-7;501
2005;2851;Kilchberg (BL);1304;Bezirk Sissach;9;VR Farnsberg plus;7;Planungsregion Oberbaselbiet;107;0;0;0;4;5;-1;0;-1;106
2005;2852;Läufelfingen;1304;Bezirk Sissach;8;VR Oberes Homburgertal;7;Planungsregion Oberbaselbiet;1270;10;18;-8;65;64;1;0;-7;1263
2005;2853;Maisprach;1304;Bezirk Sissach;9;VR Farnsberg plus;7;Planungsregion Oberbaselbiet;918;8;6;2;59;48;11;0;13;931
2005;2854;Nusshof;1304;Bezirk Sissach;7;VR Oberbaselbiet;7;Planungsregion Oberbaselbiet;197;2;1;1;15;13;2;0;3;200
2005;2855;Oltingen;1304;Bezirk Sissach;9;VR Farnsberg plus;7;Planungsregion Oberbaselbiet;406;4;7;-3;41;30;11;0;8;414
2005;2856;Ormalingen;1304;Bezirk Sissach;7;VR Oberbaselbiet;7;Planungsregion Oberbaselbiet;1828;11;13;-2;148;133;15;0;13;1841
2005;2857;Rickenbach (BL);1304;Bezirk Sissach;9;VR Farnsberg plus;7;Planungsregion Oberbaselbiet;573;6;4;2;34;47;-13;0;-11;562
2005;2858;Rothenfluh;1304;Bezirk Sissach;9;VR Farnsberg plus;7;Planungsregion Oberbaselbiet;708;9;6;3;66;63;3;0;6;714
2005;2859;Rümlingen;1304;Bezirk Sissach;8;VR Oberes Homburgertal;7;Planungsregion Oberbaselbiet;346;7;1;6;34;23;11;0;17;363
2005;2860;Rünenberg;1304;Bezirk Sissach;9;VR Farnsberg plus;7;Planungsregion Oberbaselbiet;759;8;5;3;44;39;5;0;8;767
2005;2861;Sissach;1304;Bezirk Sissach;7;VR Oberbaselbiet;7;Planungsregion Oberbaselbiet;5629;68;51;17;559;427;132;0;149;5778
2005;2862;Tecknau;1304;Bezirk Sissach;7;VR Oberbaselbiet;7;Planungsregion Oberbaselbiet;860;11;3;8;62;90;-28;0;-20;840
2005;2863;Tenniken;1304;Bezirk Sissach;7;VR Oberbaselbiet;7;Planungsregion Oberbaselbiet;911;9;4;5;62;78;-16;0;-11;900
2005;2864;Thürnen;1304;Bezirk Sissach;7;VR Oberbaselbiet;7;Planungsregion Oberbaselbiet;1238;7;10;-3;90;105;-15;0;-18;1220
2005;2865;Wenslingen;1304;Bezirk Sissach;7;VR Oberbaselbiet;7;Planungsregion Oberbaselbiet;662;9;5;4;47;34;13;0;17;679
2005;2866;Wintersingen;1304;Bezirk Sissach;9;VR Farnsberg plus;7;Planungsregion Oberbaselbiet;619;2;6;-4;36;48;-12;0;-16;603
2005;2867;Wittinsburg;1304;Bezirk Sissach;7;VR Oberbaselbiet;7;Planungsregion Oberbaselbiet;417;6;3;3;22;31;-9;0;-6;411
2005;2868;Zeglingen;1304;Bezirk Sissach;9;VR Farnsberg plus;7;Planungsregion Oberbaselbiet;471;2;6;-4;12;18;-6;0;-10;461
2005;2869;Zunzgen;1304;Bezirk Sissach;7;VR Oberbaselbiet;7;Planungsregion Oberbaselbiet;2516;15;14;1;190;174;16;0;17;2533
2005;2881;Arboldswil;1305;Bezirk Waldenburg;10;VR Waldenburgertal plus;8;VR Waldenburgertal plus;509;5;5;0;32;24;8;0;8;517
2005;2882;Bennwil;1305;Bezirk Waldenburg;10;VR Waldenburgertal plus;8;VR Waldenburgertal plus;625;7;5;2;43;45;-2;0;0;625
2005;2883;Bretzwil;1305;Bezirk Waldenburg;10;VR Waldenburgertal plus;8;VR Waldenburgertal plus;773;7;7;0;36;48;-12;0;-12;761
2005;2884;Diegten;1305;Bezirk Waldenburg;7;VR Oberbaselbiet;7;Planungsregion Oberbaselbiet;1518;15;7;8;101;114;-13;0;-5;1513
2005;2885;Eptingen;1305;Bezirk Waldenburg;7;VR Oberbaselbiet;7;Planungsregion Oberbaselbiet;552;4;4;0;32;35;-3;0;-3;549
2005;2886;Hölstein;1305;Bezirk Waldenburg;10;VR Waldenburgertal plus;8;VR Waldenburgertal plus;2243;28;9;19;173;157;16;-1;34;2277
2005;2887;Lampenberg;1305;Bezirk Waldenburg;10;VR Waldenburgertal plus;8;VR Waldenburgertal plus;507;3;4;-1;21;30;-9;0;-10;497
2005;2888;Langenbruck;1305;Bezirk Waldenburg;10;VR Waldenburgertal plus;8;VR Waldenburgertal plus;999;11;4;7;90;85;5;-1;11;1010
2005;2889;Lauwil;1305;Bezirk Waldenburg;10;VR Waldenburgertal plus;8;VR Waldenburgertal plus;329;2;4;-2;23;29;-6;0;-8;321
2005;2890;Liedertswil;1305;Bezirk Waldenburg;10;VR Waldenburgertal plus;8;VR Waldenburgertal plus;160;1;1;0;5;12;-7;0;-7;153
2005;2891;Niederdorf;1305;Bezirk Waldenburg;10;VR Waldenburgertal plus;8;VR Waldenburgertal plus;1798;14;17;-3;137;154;-17;0;-20;1778
2005;2892;Oberdorf (BL);1305;Bezirk Waldenburg;10;VR Waldenburgertal plus;8;VR Waldenburgertal plus;2299;22;18;4;163;138;25;0;29;2328
2005;2893;Reigoldswil;1305;Bezirk Waldenburg;10;VR Waldenburgertal plus;8;VR Waldenburgertal plus;1526;20;12;8;101;110;-9;0;-1;1525
2005;2894;Titterten;1305;Bezirk Waldenburg;10;VR Waldenburgertal plus;8;VR Waldenburgertal plus;415;2;3;-1;29;31;-2;0;-3;412
2005;2895;Waldenburg;1305;Bezirk Waldenburg;10;VR Waldenburgertal plus;8;VR Waldenburgertal plus;1307;13;9;4;122;132;-10;0;-6;1301
2006;2761;Aesch (BL);1301;Bezirk Arlesheim;3;VR Alter Birsstadt;3;VR Alter Birsstadt;9929;89;67;22;742;678;64;0;86;10015
2006;2762;Allschwil;1301;Bezirk Arlesheim;1;VR Alter und Gesundheit ABS;1;VR Alter und Gesundheit ABS;18354;130;154;-24;1509;1208;301;0;277;18631
2006;2763;Arlesheim;1301;Bezirk Arlesheim;3;VR Alter Birsstadt;3;VR Alter Birsstadt;8927;74;76;-2;625;623;2;0;0;8927
2006;2764;Biel-Benken;1301;Bezirk Arlesheim;4;VR BPA Leimental;4;VR BPA Leimental;2917;20;15;5;347;215;132;0;137;3054
2006;2765;Binningen;1301;Bezirk Arlesheim;1;VR Alter und Gesundheit ABS;1;VR Alter und Gesundheit ABS;14400;129;134;-5;1090;1099;-9;-2;-16;14384
2006;2766;Birsfelden;1301;Bezirk Arlesheim;2;VR APG Rheintal;2;VR APG Rheintal;10364;81;97;-16;704;691;13;0;-3;10361
2006;2767;Bottmingen;1301;Bezirk Arlesheim;4;VR BPA Leimental;4;VR BPA Leimental;5755;40;40;0;555;562;-7;0;-7;5748
2006;2768;Ettingen;1301;Bezirk Arlesheim;4;VR BPA Leimental;4;VR BPA Leimental;4844;38;22;16;319;350;-31;0;-15;4829
2006;2769;Münchenstein;1301;Bezirk Arlesheim;3;VR Alter Birsstadt;3;VR Alter Birsstadt;11726;115;95;20;776;816;-40;0;-20;11706
2006;2770;Muttenz;1301;Bezirk Arlesheim;2;VR APG Rheintal;2;VR APG Rheintal;16968;110;144;-34;1123;993;130;-1;95;17063
2006;2771;Oberwil (BL);1301;Bezirk Arlesheim;4;VR BPA Leimental;4;VR BPA Leimental;10057;94;85;9;894;693;201;0;210;10267
2006;2772;Pfeffingen;1301;Bezirk Arlesheim;3;VR Alter Birsstadt;3;VR Alter Birsstadt;2165;14;10;4;104;115;-11;0;-7;2158
2006;2773;Reinach (BL);1301;Bezirk Arlesheim;3;VR Alter Birsstadt;3;VR Alter Birsstadt;18693;129;140;-11;1250;1172;78;0;67;18760
2006;2774;Schönenbuch;1301;Bezirk Arlesheim;1;VR Alter und Gesundheit ABS;1;VR Alter und Gesundheit ABS;1410;11;12;-1;91;72;19;0;18;1428
2006;2775;Therwil;1301;Bezirk Arlesheim;4;VR BPA Leimental;4;VR BPA Leimental;9345;69;52;17;640;652;-12;1;6;9351
2006;2781;Blauen;1302;Bezirk Laufen;5;VR APG Laufental;5;VR APG Laufental;680;1;4;-3;33;27;6;0;3;683
2006;2782;Brislach;1302;Bezirk Laufen;5;VR APG Laufental;5;VR APG Laufental;1483;8;5;3;106;81;25;0;28;1511
2006;2783;Burg im Leimental;1302;Bezirk Laufen;4;VR BPA Leimental;4;VR BPA Leimental;248;2;6;-4;9;20;-11;0;-15;233
2006;2784;Dittingen;1302;Bezirk Laufen;5;VR APG Laufental;5;VR APG Laufental;694;4;2;2;57;54;3;0;5;699
2006;2785;Duggingen;1302;Bezirk Laufen;3;VR Alter Birsstadt;3;VR Alter Birsstadt;1270;10;8;2;133;93;40;0;42;1312
2006;2786;Grellingen;1302;Bezirk Laufen;5;VR APG Laufental;5;VR APG Laufental;1719;17;8;9;100;131;-31;0;-22;1697
2006;2787;Laufen;1302;Bezirk Laufen;5;VR APG Laufental;5;VR APG Laufental;5224;43;50;-7;329;338;-9;0;-16;5208
2006;2788;Liesberg;1302;Bezirk Laufen;5;VR APG Laufental;5;VR APG Laufental;1173;11;11;0;78;68;10;0;10;1183
2006;2789;Nenzlingen;1302;Bezirk Laufen;5;VR APG Laufental;5;VR APG Laufental;405;1;3;-2;24;16;8;1;7;412
2006;2790;Roggenburg;1302;Bezirk Laufen;5;VR APG Laufental;5;VR APG Laufental;262;6;0;6;18;9;9;0;15;277
2006;2791;Röschenz;1302;Bezirk Laufen;5;VR APG Laufental;5;VR APG Laufental;1731;16;8;8;132;117;15;0;23;1754
2006;2792;Wahlen;1302;Bezirk Laufen;5;VR APG Laufental;5;VR APG Laufental;1323;13;2;11;85;80;5;0;16;1339
2006;2793;Zwingen;1302;Bezirk Laufen;5;VR APG Laufental;5;VR APG Laufental;2064;24;4;20;173;169;4;0;24;2088
2006;2821;Arisdorf;1303;Bezirk Liestal;6;VR Alters- und Pflegeregion Liestal;6;VR Alters- und Pflegeregion Liestal;1482;13;10;3;100;103;-3;0;0;1482
2006;2822;Augst;1303;Bezirk Liestal;2;VR APG Rheintal;2;VR APG Rheintal;919;3;7;-4;76;83;-7;0;-11;908
2006;2823;Bubendorf;1303;Bezirk Liestal;6;VR Alters- und Pflegeregion Liestal;6;VR Alters- und Pflegeregion Liestal;4393;27;14;13;235;281;-46;0;-33;4360
2006;2824;Frenkendorf;1303;Bezirk Liestal;6;VR Alters- und Pflegeregion Liestal;6;VR Alters- und Pflegeregion Liestal;6128;75;28;47;393;455;-62;0;-15;6113
2006;2825;Füllinsdorf;1303;Bezirk Liestal;6;VR Alters- und Pflegeregion Liestal;6;VR Alters- und Pflegeregion Liestal;4309;50;37;13;355;344;11;0;24;4333
2006;2826;Giebenach;1303;Bezirk Liestal;2;VR APG Rheintal;2;VR APG Rheintal;899;7;2;5;139;67;72;0;77;976
2006;2827;Hersberg;1303;Bezirk Liestal;6;VR Alters- und Pflegeregion Liestal;6;VR Alters- und Pflegeregion Liestal;270;2;1;1;24;17;7;0;8;278
2006;2828;Lausen;1303;Bezirk Liestal;6;VR Alters- und Pflegeregion Liestal;6;VR Alters- und Pflegeregion Liestal;4823;49;28;21;262;342;-80;0;-59;4764
2006;2829;Liestal;1303;Bezirk Liestal;6;VR Alters- und Pflegeregion Liestal;6;VR Alters- und Pflegeregion Liestal;13213;126;110;16;1153;1094;59;0;75;13288
2006;2830;Lupsingen;1303;Bezirk Liestal;6;VR Alters- und Pflegeregion Liestal;6;VR Alters- und Pflegeregion Liestal;1294;11;7;4;88;74;14;0;18;1312
2006;2831;Pratteln;1303;Bezirk Liestal;2;VR APG Rheintal;2;VR APG Rheintal;14976;164;118;46;994;968;26;0;72;15048
2006;2832;Ramlinsburg;1303;Bezirk Liestal;10;VR Waldenburgertal plus;8;VR Waldenburgertal plus;702;3;2;1;43;36;7;0;8;710
2006;2833;Seltisberg;1303;Bezirk Liestal;6;VR Alters- und Pflegeregion Liestal;6;VR Alters- und Pflegeregion Liestal;1318;9;8;1;88;77;11;0;12;1330
2006;2834;Ziefen;1303;Bezirk Liestal;6;VR Alters- und Pflegeregion Liestal;6;VR Alters- und Pflegeregion Liestal;1462;21;6;15;94;85;9;0;24;1486
2006;2841;Anwil;1304;Bezirk Sissach;9;VR Farnsberg plus;7;Planungsregion Oberbaselbiet;541;11;3;8;23;25;-2;-1;5;546
2006;2842;Böckten;1304;Bezirk Sissach;7;VR Oberbaselbiet;7;Planungsregion Oberbaselbiet;754;8;3;5;49;57;-8;0;-3;751
2006;2843;Buckten;1304;Bezirk Sissach;8;VR Oberes Homburgertal;7;Planungsregion Oberbaselbiet;672;4;5;-1;62;48;14;0;13;685
2006;2844;Buus;1304;Bezirk Sissach;9;VR Farnsberg plus;7;Planungsregion Oberbaselbiet;952;4;2;2;60;38;22;0;24;976
2006;2845;Diepflingen;1304;Bezirk Sissach;7;VR Oberbaselbiet;7;Planungsregion Oberbaselbiet;546;4;4;0;21;30;-9;0;-9;537
2006;2846;Gelterkinden;1304;Bezirk Sissach;7;VR Oberbaselbiet;7;Planungsregion Oberbaselbiet;5584;54;42;12;365;331;34;0;46;5630
2006;2847;Häfelfingen;1304;Bezirk Sissach;8;VR Oberes Homburgertal;7;Planungsregion Oberbaselbiet;276;3;1;2;7;11;-4;0;-2;274
2006;2848;Hemmiken;1304;Bezirk Sissach;9;VR Farnsberg plus;7;Planungsregion Oberbaselbiet;276;1;4;-3;12;9;3;0;0;276
2006;2849;Itingen;1304;Bezirk Sissach;7;VR Oberbaselbiet;7;Planungsregion Oberbaselbiet;1809;10;11;-1;150;139;11;0;10;1819
2006;2850;Känerkinden;1304;Bezirk Sissach;8;VR Oberes Homburgertal;7;Planungsregion Oberbaselbiet;501;6;6;0;19;32;-13;0;-13;488
2006;2851;Kilchberg (BL);1304;Bezirk Sissach;9;VR Farnsberg plus;7;Planungsregion Oberbaselbiet;106;0;1;-1;9;8;1;0;0;106
2006;2852;Läufelfingen;1304;Bezirk Sissach;8;VR Oberes Homburgertal;7;Planungsregion Oberbaselbiet;1263;10;11;-1;75;68;7;0;6;1269
2006;2853;Maisprach;1304;Bezirk Sissach;9;VR Farnsberg plus;7;Planungsregion Oberbaselbiet;931;7;7;0;55;49;6;0;6;937
2006;2854;Nusshof;1304;Bezirk Sissach;7;VR Oberbaselbiet;7;Planungsregion Oberbaselbiet;200;0;0;0;11;13;-2;0;-2;198
2006;2855;Oltingen;1304;Bezirk Sissach;9;VR Farnsberg plus;7;Planungsregion Oberbaselbiet;414;4;3;1;36;27;9;0;10;424
2006;2856;Ormalingen;1304;Bezirk Sissach;7;VR Oberbaselbiet;7;Planungsregion Oberbaselbiet;1841;7;12;-5;152;109;43;0;38;1879
2006;2857;Rickenbach (BL);1304;Bezirk Sissach;9;VR Farnsberg plus;7;Planungsregion Oberbaselbiet;562;4;3;1;32;36;-4;0;-3;559
2006;2858;Rothenfluh;1304;Bezirk Sissach;9;VR Farnsberg plus;7;Planungsregion Oberbaselbiet;714;8;2;6;34;32;2;0;8;722
2006;2859;Rümlingen;1304;Bezirk Sissach;8;VR Oberes Homburgertal;7;Planungsregion Oberbaselbiet;363;1;4;-3;23;35;-12;0;-15;348
2006;2860;Rünenberg;1304;Bezirk Sissach;9;VR Farnsberg plus;7;Planungsregion Oberbaselbiet;767;10;6;4;40;32;8;0;12;779
2006;2861;Sissach;1304;Bezirk Sissach;7;VR Oberbaselbiet;7;Planungsregion Oberbaselbiet;5778;45;54;-9;532;543;-11;0;-20;5758
2006;2862;Tecknau;1304;Bezirk Sissach;7;VR Oberbaselbiet;7;Planungsregion Oberbaselbiet;840;6;6;0;53;67;-14;0;-14;826
2006;2863;Tenniken;1304;Bezirk Sissach;7;VR Oberbaselbiet;7;Planungsregion Oberbaselbiet;900;9;7;2;63;52;11;0;13;913
2006;2864;Thürnen;1304;Bezirk Sissach;7;VR Oberbaselbiet;7;Planungsregion Oberbaselbiet;1220;13;4;9;106;115;-9;0;0;1220
2006;2865;Wenslingen;1304;Bezirk Sissach;7;VR Oberbaselbiet;7;Planungsregion Oberbaselbiet;679;5;2;3;34;32;2;0;5;684
2006;2866;Wintersingen;1304;Bezirk Sissach;9;VR Farnsberg plus;7;Planungsregion Oberbaselbiet;603;6;10;-4;22;20;2;0;-2;601
2006;2867;Wittinsburg;1304;Bezirk Sissach;7;VR Oberbaselbiet;7;Planungsregion Oberbaselbiet;411;9;0;9;21;27;-6;0;3;414
2006;2868;Zeglingen;1304;Bezirk Sissach;9;VR Farnsberg plus;7;Planungsregion Oberbaselbiet;461;5;7;-2;17;23;-6;0;-8;453
2006;2869;Zunzgen;1304;Bezirk Sissach;7;VR Oberbaselbiet;7;Planungsregion Oberbaselbiet;2533;17;15;2;178;212;-34;0;-32;2501
2006;2881;Arboldswil;1305;Bezirk Waldenburg;10;VR Waldenburgertal plus;8;VR Waldenburgertal plus;517;5;3;2;23;38;-15;0;-13;504
2006;2882;Bennwil;1305;Bezirk Waldenburg;10;VR Waldenburgertal plus;8;VR Waldenburgertal plus;625;14;5;9;29;36;-7;0;2;627
2006;2883;Bretzwil;1305;Bezirk Waldenburg;10;VR Waldenburgertal plus;8;VR Waldenburgertal plus;761;11;4;7;43;36;7;0;14;775
2006;2884;Diegten;1305;Bezirk Waldenburg;7;VR Oberbaselbiet;7;Planungsregion Oberbaselbiet;1513;8;9;-1;137;105;32;0;31;1544
2006;2885;Eptingen;1305;Bezirk Waldenburg;7;VR Oberbaselbiet;7;Planungsregion Oberbaselbiet;549;10;6;4;29;36;-7;0;-3;546
2006;2886;Hölstein;1305;Bezirk Waldenburg;10;VR Waldenburgertal plus;8;VR Waldenburgertal plus;2277;21;22;-1;179;167;12;0;11;2288
2006;2887;Lampenberg;1305;Bezirk Waldenburg;10;VR Waldenburgertal plus;8;VR Waldenburgertal plus;497;4;4;0;32;24;8;0;8;505
2006;2888;Langenbruck;1305;Bezirk Waldenburg;10;VR Waldenburgertal plus;8;VR Waldenburgertal plus;1010;7;4;3;70;57;13;0;16;1026
2006;2889;Lauwil;1305;Bezirk Waldenburg;10;VR Waldenburgertal plus;8;VR Waldenburgertal plus;321;3;2;1;18;13;5;0;6;327
2006;2890;Liedertswil;1305;Bezirk Waldenburg;10;VR Waldenburgertal plus;8;VR Waldenburgertal plus;153;2;1;1;11;12;-1;0;0;153
2006;2891;Niederdorf;1305;Bezirk Waldenburg;10;VR Waldenburgertal plus;8;VR Waldenburgertal plus;1778;19;15;4;126;132;-6;0;-2;1776
2006;2892;Oberdorf (BL);1305;Bezirk Waldenburg;10;VR Waldenburgertal plus;8;VR Waldenburgertal plus;2328;21;15;6;135;145;-10;0;-4;2324
2006;2893;Reigoldswil;1305;Bezirk Waldenburg;10;VR Waldenburgertal plus;8;VR Waldenburgertal plus;1525;11;14;-3;114;126;-12;0;-15;1510
2006;2894;Titterten;1305;Bezirk Waldenburg;10;VR Waldenburgertal plus;8;VR Waldenburgertal plus;412;4;5;-1;36;29;7;-1;5;417
2006;2895;Waldenburg;1305;Bezirk Waldenburg;10;VR Waldenburgertal plus;8;VR Waldenburgertal plus;1301;14;21;-7;94;111;-17;0;-24;1277
2007;2761;Aesch (BL);1301;Bezirk Arlesheim;3;VR Alter Birsstadt;3;VR Alter Birsstadt;10015;93;62;31;779;801;-22;0;9;10024
2007;2762;Allschwil;1301;Bezirk Arlesheim;1;VR Alter und Gesundheit ABS;1;VR Alter und Gesundheit ABS;18631;175;169;6;1478;1255;223;-1;228;18859
2007;2763;Arlesheim;1301;Bezirk Arlesheim;3;VR Alter Birsstadt;3;VR Alter Birsstadt;8927;74;75;-1;680;623;57;0;56;8983
2007;2764;Biel-Benken;1301;Bezirk Arlesheim;4;VR BPA Leimental;4;VR BPA Leimental;3054;27;9;18;264;226;38;0;56;3110
2007;2765;Binningen;1301;Bezirk Arlesheim;1;VR Alter und Gesundheit ABS;1;VR Alter und Gesundheit ABS;14384;131;134;-3;1161;1135;26;0;23;14407
2007;2766;Birsfelden;1301;Bezirk Arlesheim;2;VR APG Rheintal;2;VR APG Rheintal;10361;89;104;-15;765;701;64;-1;48;10409
2007;2767;Bottmingen;1301;Bezirk Arlesheim;4;VR BPA Leimental;4;VR BPA Leimental;5748;57;39;18;659;524;135;0;153;5901
2007;2768;Ettingen;1301;Bezirk Arlesheim;4;VR BPA Leimental;4;VR BPA Leimental;4829;26;28;-2;350;345;5;0;3;4832
2007;2769;Münchenstein;1301;Bezirk Arlesheim;3;VR Alter Birsstadt;3;VR Alter Birsstadt;11706;85;109;-24;875;830;45;0;21;11727
2007;2770;Muttenz;1301;Bezirk Arlesheim;2;VR APG Rheintal;2;VR APG Rheintal;17063;125;159;-34;1120;1015;105;0;71;17134
2007;2771;Oberwil (BL);1301;Bezirk Arlesheim;4;VR BPA Leimental;4;VR BPA Leimental;10267;94;74;20;871;778;93;0;113;10380
2007;2772;Pfeffingen;1301;Bezirk Arlesheim;3;VR Alter Birsstadt;3;VR Alter Birsstadt;2158;10;7;3;127;160;-33;0;-30;2128
2007;2773;Reinach (BL);1301;Bezirk Arlesheim;3;VR Alter Birsstadt;3;VR Alter Birsstadt;18760;149;139;10;1315;1166;149;0;159;18919
2007;2774;Schönenbuch;1301;Bezirk Arlesheim;1;VR Alter und Gesundheit ABS;1;VR Alter und Gesundheit ABS;1428;8;12;-4;63;65;-2;0;-6;1422
2007;2775;Therwil;1301;Bezirk Arlesheim;4;VR BPA Leimental;4;VR BPA Leimental;9351;80;79;1;645;591;54;1;56;9407
2007;2781;Blauen;1302;Bezirk Laufen;5;VR APG Laufental;5;VR APG Laufental;683;7;3;4;27;36;-9;0;-5;678
2007;2782;Brislach;1302;Bezirk Laufen;5;VR APG Laufental;5;VR APG Laufental;1511;10;8;2;129;72;57;0;59;1570
2007;2783;Burg im Leimental;1302;Bezirk Laufen;4;VR BPA Leimental;4;VR BPA Leimental;233;2;3;-1;13;21;-8;0;-9;224
2007;2784;Dittingen;1302;Bezirk Laufen;5;VR APG Laufental;5;VR APG Laufental;699;5;8;-3;74;61;13;0;10;709
2007;2785;Duggingen;1302;Bezirk Laufen;3;VR Alter Birsstadt;3;VR Alter Birsstadt;1312;17;3;14;152;100;52;0;66;1378
2007;2786;Grellingen;1302;Bezirk Laufen;5;VR APG Laufental;5;VR APG Laufental;1697;15;24;-9;167;144;23;0;14;1711
2007;2787;Laufen;1302;Bezirk Laufen;5;VR APG Laufental;5;VR APG Laufental;5208;54;41;13;351;350;1;0;14;5222
2007;2788;Liesberg;1302;Bezirk Laufen;5;VR APG Laufental;5;VR APG Laufental;1183;11;11;0;83;69;14;0;14;1197
2007;2789;Nenzlingen;1302;Bezirk Laufen;5;VR APG Laufental;5;VR APG Laufental;412;5;2;3;26;35;-9;0;-6;406
2007;2790;Roggenburg;1302;Bezirk Laufen;5;VR APG Laufental;5;VR APG Laufental;277;0;1;-1;22;13;9;0;8;285
2007;2791;Röschenz;1302;Bezirk Laufen;5;VR APG Laufental;5;VR APG Laufental;1754;24;8;16;127;101;26;0;42;1796
2007;2792;Wahlen;1302;Bezirk Laufen;5;VR APG Laufental;5;VR APG Laufental;1339;14;7;7;86;73;13;0;20;1359
2007;2793;Zwingen;1302;Bezirk Laufen;5;VR APG Laufental;5;VR APG Laufental;2088;14;14;0;242;195;47;0;47;2135
2007;2821;Arisdorf;1303;Bezirk Liestal;6;VR Alters- und Pflegeregion Liestal;6;VR Alters- und Pflegeregion Liestal;1482;14;7;7;138;112;26;0;33;1515
2007;2822;Augst;1303;Bezirk Liestal;2;VR APG Rheintal;2;VR APG Rheintal;908;3;6;-3;57;61;-4;0;-7;901
2007;2823;Bubendorf;1303;Bezirk Liestal;6;VR Alters- und Pflegeregion Liestal;6;VR Alters- und Pflegeregion Liestal;4360;31;28;3;294;288;6;0;9;4369
2007;2824;Frenkendorf;1303;Bezirk Liestal;6;VR Alters- und Pflegeregion Liestal;6;VR Alters- und Pflegeregion Liestal;6113;60;32;28;475;453;22;0;50;6163
2007;2825;Füllinsdorf;1303;Bezirk Liestal;6;VR Alters- und Pflegeregion Liestal;6;VR Alters- und Pflegeregion Liestal;4333;46;35;11;335;377;-42;0;-31;4302
2007;2826;Giebenach;1303;Bezirk Liestal;2;VR APG Rheintal;2;VR APG Rheintal;976;12;8;4;67;68;-1;0;3;979
2007;2827;Hersberg;1303;Bezirk Liestal;6;VR Alters- und Pflegeregion Liestal;6;VR Alters- und Pflegeregion Liestal;278;2;0;2;28;12;16;0;18;296
2007;2828;Lausen;1303;Bezirk Liestal;6;VR Alters- und Pflegeregion Liestal;6;VR Alters- und Pflegeregion Liestal;4764;49;30;19;369;349;20;-1;38;4802
2007;2829;Liestal;1303;Bezirk Liestal;6;VR Alters- und Pflegeregion Liestal;6;VR Alters- und Pflegeregion Liestal;13288;134;115;19;1171;1056;115;0;134;13422
2007;2830;Lupsingen;1303;Bezirk Liestal;6;VR Alters- und Pflegeregion Liestal;6;VR Alters- und Pflegeregion Liestal;1312;12;7;5;72;92;-20;0;-15;1297
2007;2831;Pratteln;1303;Bezirk Liestal;2;VR APG Rheintal;2;VR APG Rheintal;15048;136;99;37;1039;1054;-15;0;22;15070
2007;2832;Ramlinsburg;1303;Bezirk Liestal;10;VR Waldenburgertal plus;8;VR Waldenburgertal plus;710;4;3;1;54;48;6;0;7;717
2007;2833;Seltisberg;1303;Bezirk Liestal;6;VR Alters- und Pflegeregion Liestal;6;VR Alters- und Pflegeregion Liestal;1330;9;10;-1;96;93;3;0;2;1332
2007;2834;Ziefen;1303;Bezirk Liestal;6;VR Alters- und Pflegeregion Liestal;6;VR Alters- und Pflegeregion Liestal;1486;16;10;6;100;74;26;0;32;1518
2007;2841;Anwil;1304;Bezirk Sissach;9;VR Farnsberg plus;7;Planungsregion Oberbaselbiet;546;3;6;-3;42;18;24;0;21;567
2007;2842;Böckten;1304;Bezirk Sissach;7;VR Oberbaselbiet;7;Planungsregion Oberbaselbiet;751;7;7;0;77;65;12;0;12;763
2007;2843;Buckten;1304;Bezirk Sissach;8;VR Oberes Homburgertal;7;Planungsregion Oberbaselbiet;685;6;5;1;46;44;2;0;3;688
2007;2844;Buus;1304;Bezirk Sissach;9;VR Farnsberg plus;7;Planungsregion Oberbaselbiet;976;13;7;6;33;53;-20;0;-14;962
2007;2845;Diepflingen;1304;Bezirk Sissach;7;VR Oberbaselbiet;7;Planungsregion Oberbaselbiet;537;3;2;1;42;35;7;0;8;545
2007;2846;Gelterkinden;1304;Bezirk Sissach;7;VR Oberbaselbiet;7;Planungsregion Oberbaselbiet;5630;42;47;-5;395;397;-2;0;-7;5623
2007;2847;Häfelfingen;1304;Bezirk Sissach;8;VR Oberes Homburgertal;7;Planungsregion Oberbaselbiet;274;0;2;-2;10;11;-1;0;-3;271
2007;2848;Hemmiken;1304;Bezirk Sissach;9;VR Farnsberg plus;7;Planungsregion Oberbaselbiet;276;3;3;0;16;22;-6;0;-6;270
2007;2849;Itingen;1304;Bezirk Sissach;7;VR Oberbaselbiet;7;Planungsregion Oberbaselbiet;1819;17;14;3;156;162;-6;-1;-4;1815
2007;2850;Känerkinden;1304;Bezirk Sissach;8;VR Oberes Homburgertal;7;Planungsregion Oberbaselbiet;488;3;5;-2;31;23;8;0;6;494
2007;2851;Kilchberg (BL);1304;Bezirk Sissach;9;VR Farnsberg plus;7;Planungsregion Oberbaselbiet;106;1;1;0;31;5;26;0;26;132
2007;2852;Läufelfingen;1304;Bezirk Sissach;8;VR Oberes Homburgertal;7;Planungsregion Oberbaselbiet;1269;11;7;4;66;65;1;0;5;1274
2007;2853;Maisprach;1304;Bezirk Sissach;9;VR Farnsberg plus;7;Planungsregion Oberbaselbiet;937;3;4;-1;75;55;20;0;19;956
2007;2854;Nusshof;1304;Bezirk Sissach;7;VR Oberbaselbiet;7;Planungsregion Oberbaselbiet;198;2;3;-1;6;4;2;0;1;199
2007;2855;Oltingen;1304;Bezirk Sissach;9;VR Farnsberg plus;7;Planungsregion Oberbaselbiet;424;5;2;3;19;29;-10;0;-7;417
2007;2856;Ormalingen;1304;Bezirk Sissach;7;VR Oberbaselbiet;7;Planungsregion Oberbaselbiet;1879;19;12;7;151;152;-1;0;6;1885
2007;2857;Rickenbach (BL);1304;Bezirk Sissach;9;VR Farnsberg plus;7;Planungsregion Oberbaselbiet;559;4;6;-2;43;44;-1;0;-3;556
2007;2858;Rothenfluh;1304;Bezirk Sissach;9;VR Farnsberg plus;7;Planungsregion Oberbaselbiet;722;5;4;1;38;35;3;0;4;726
2007;2859;Rümlingen;1304;Bezirk Sissach;8;VR Oberes Homburgertal;7;Planungsregion Oberbaselbiet;348;8;3;5;38;44;-6;0;-1;347
2007;2860;Rünenberg;1304;Bezirk Sissach;9;VR Farnsberg plus;7;Planungsregion Oberbaselbiet;779;4;9;-5;33;32;1;0;-4;775
2007;2861;Sissach;1304;Bezirk Sissach;7;VR Oberbaselbiet;7;Planungsregion Oberbaselbiet;5758;63;43;20;521;454;67;0;87;5845
2007;2862;Tecknau;1304;Bezirk Sissach;7;VR Oberbaselbiet;7;Planungsregion Oberbaselbiet;826;5;3;2;49;64;-15;0;-13;813
2007;2863;Tenniken;1304;Bezirk Sissach;7;VR Oberbaselbiet;7;Planungsregion Oberbaselbiet;913;5;6;-1;40;65;-25;0;-26;887
2007;2864;Thürnen;1304;Bezirk Sissach;7;VR Oberbaselbiet;7;Planungsregion Oberbaselbiet;1220;11;6;5;161;112;49;0;54;1274
2007;2865;Wenslingen;1304;Bezirk Sissach;7;VR Oberbaselbiet;7;Planungsregion Oberbaselbiet;684;4;7;-3;43;37;6;0;3;687
2007;2866;Wintersingen;1304;Bezirk Sissach;9;VR Farnsberg plus;7;Planungsregion Oberbaselbiet;601;4;3;1;41;24;17;0;18;619
2007;2867;Wittinsburg;1304;Bezirk Sissach;7;VR Oberbaselbiet;7;Planungsregion Oberbaselbiet;414;5;3;2;26;27;-1;0;1;415
2007;2868;Zeglingen;1304;Bezirk Sissach;9;VR Farnsberg plus;7;Planungsregion Oberbaselbiet;453;6;9;-3;25;17;8;0;5;458
2007;2869;Zunzgen;1304;Bezirk Sissach;7;VR Oberbaselbiet;7;Planungsregion Oberbaselbiet;2501;15;17;-2;175;181;-6;1;-7;2494
2007;2881;Arboldswil;1305;Bezirk Waldenburg;10;VR Waldenburgertal plus;8;VR Waldenburgertal plus;504;8;4;4;24;22;2;0;6;510
2007;2882;Bennwil;1305;Bezirk Waldenburg;10;VR Waldenburgertal plus;8;VR Waldenburgertal plus;627;14;4;10;40;54;-14;0;-4;623
2007;2883;Bretzwil;1305;Bezirk Waldenburg;10;VR Waldenburgertal plus;8;VR Waldenburgertal plus;775;10;4;6;57;49;8;0;14;789
2007;2884;Diegten;1305;Bezirk Waldenburg;7;VR Oberbaselbiet;7;Planungsregion Oberbaselbiet;1544;15;5;10;101;93;8;0;18;1562
2007;2885;Eptingen;1305;Bezirk Waldenburg;7;VR Oberbaselbiet;7;Planungsregion Oberbaselbiet;546;5;3;2;30;37;-7;0;-5;541
2007;2886;Hölstein;1305;Bezirk Waldenburg;10;VR Waldenburgertal plus;8;VR Waldenburgertal plus;2288;23;14;9;204;159;45;0;54;2342
2007;2887;Lampenberg;1305;Bezirk Waldenburg;10;VR Waldenburgertal plus;8;VR Waldenburgertal plus;505;3;4;-1;33;32;1;0;0;505
2007;2888;Langenbruck;1305;Bezirk Waldenburg;10;VR Waldenburgertal plus;8;VR Waldenburgertal plus;1026;8;9;-1;49;85;-36;0;-37;989
2007;2889;Lauwil;1305;Bezirk Waldenburg;10;VR Waldenburgertal plus;8;VR Waldenburgertal plus;327;1;4;-3;20;15;5;0;2;329
2007;2890;Liedertswil;1305;Bezirk Waldenburg;10;VR Waldenburgertal plus;8;VR Waldenburgertal plus;153;4;2;2;11;12;-1;0;1;154
2007;2891;Niederdorf;1305;Bezirk Waldenburg;10;VR Waldenburgertal plus;8;VR Waldenburgertal plus;1776;11;18;-7;164;135;29;0;22;1798
2007;2892;Oberdorf (BL);1305;Bezirk Waldenburg;10;VR Waldenburgertal plus;8;VR Waldenburgertal plus;2324;16;25;-9;145;180;-35;0;-44;2280
2007;2893;Reigoldswil;1305;Bezirk Waldenburg;10;VR Waldenburgertal plus;8;VR Waldenburgertal plus;1510;11;15;-4;127;129;-2;0;-6;1504
2007;2894;Titterten;1305;Bezirk Waldenburg;10;VR Waldenburgertal plus;8;VR Waldenburgertal plus;417;1;6;-5;29;28;1;0;-4;413
2007;2895;Waldenburg;1305;Bezirk Waldenburg;10;VR Waldenburgertal plus;8;VR Waldenburgertal plus;1277;16;13;3;82;112;-30;0;-27;1250
2008;2761;Aesch (BL);1301;Bezirk Arlesheim;3;VR Alter Birsstadt;3;VR Alter Birsstadt;10024;77;91;-14;856;761;95;0;81;10105
2008;2762;Allschwil;1301;Bezirk Arlesheim;1;VR Alter und Gesundheit ABS;1;VR Alter und Gesundheit ABS;18859;167;179;-12;1633;1303;330;1;319;19178
2008;2763;Arlesheim;1301;Bezirk Arlesheim;3;VR Alter Birsstadt;3;VR Alter Birsstadt;8983;62;74;-12;597;637;-40;-1;-53;8930
2008;2764;Biel-Benken;1301;Bezirk Arlesheim;4;VR BPA Leimental;4;VR BPA Leimental;3110;24;19;5;230;203;27;0;32;3142
2008;2765;Binningen;1301;Bezirk Arlesheim;1;VR Alter und Gesundheit ABS;1;VR Alter und Gesundheit ABS;14407;140;125;15;1209;1098;111;0;126;14533
2008;2766;Birsfelden;1301;Bezirk Arlesheim;2;VR APG Rheintal;2;VR APG Rheintal;10409;110;110;0;769;769;0;0;0;10409
2008;2767;Bottmingen;1301;Bezirk Arlesheim;4;VR BPA Leimental;4;VR BPA Leimental;5901;43;42;1;710;608;102;0;103;6004
2008;2768;Ettingen;1301;Bezirk Arlesheim;4;VR BPA Leimental;4;VR BPA Leimental;4832;37;30;7;336;364;-28;0;-21;4811
2008;2769;Münchenstein;1301;Bezirk Arlesheim;3;VR Alter Birsstadt;3;VR Alter Birsstadt;11727;110;101;9;1025;927;98;-1;106;11833
2008;2770;Muttenz;1301;Bezirk Arlesheim;2;VR APG Rheintal;2;VR APG Rheintal;17134;127;171;-44;1152;1000;152;0;108;17242
2008;2771;Oberwil (BL);1301;Bezirk Arlesheim;4;VR BPA Leimental;4;VR BPA Leimental;10380;99;54;45;745;802;-57;0;-12;10368
2008;2772;Pfeffingen;1301;Bezirk Arlesheim;3;VR Alter Birsstadt;3;VR Alter Birsstadt;2128;14;13;1;160;133;27;0;28;2156
2008;2773;Reinach (BL);1301;Bezirk Arlesheim;3;VR Alter Birsstadt;3;VR Alter Birsstadt;18919;135;174;-39;1254;1265;-11;-1;-51;18868
2008;2774;Schönenbuch;1301;Bezirk Arlesheim;1;VR Alter und Gesundheit ABS;1;VR Alter und Gesundheit ABS;1422;16;5;11;91;90;1;0;12;1434
2008;2775;Therwil;1301;Bezirk Arlesheim;4;VR BPA Leimental;4;VR BPA Leimental;9407;90;48;42;697;632;65;0;107;9514
2008;2781;Blauen;1302;Bezirk Laufen;5;VR APG Laufental;5;VR APG Laufental;678;10;4;6;44;34;10;0;16;694
2008;2782;Brislach;1302;Bezirk Laufen;5;VR APG Laufental;5;VR APG Laufental;1570;15;9;6;92;76;16;0;22;1592
2008;2783;Burg im Leimental;1302;Bezirk Laufen;4;VR BPA Leimental;4;VR BPA Leimental;224;4;4;0;23;17;6;0;6;230
2008;2784;Dittingen;1302;Bezirk Laufen;5;VR APG Laufental;5;VR APG Laufental;709;6;4;2;46;52;-6;0;-4;705
2008;2785;Duggingen;1302;Bezirk Laufen;3;VR Alter Birsstadt;3;VR Alter Birsstadt;1378;14;13;1;193;136;57;0;58;1436
2008;2786;Grellingen;1302;Bezirk Laufen;5;VR APG Laufental;5;VR APG Laufental;1711;11;11;0;170;166;4;0;4;1715
2008;2787;Laufen;1302;Bezirk Laufen;5;VR APG Laufental;5;VR APG Laufental;5222;48;42;6;347;346;1;0;7;5229
2008;2788;Liesberg;1302;Bezirk Laufen;5;VR APG Laufental;5;VR APG Laufental;1197;9;13;-4;66;63;3;0;-1;1196
2008;2789;Nenzlingen;1302;Bezirk Laufen;5;VR APG Laufental;5;VR APG Laufental;406;1;1;0;28;14;14;0;14;420
2008;2790;Roggenburg;1302;Bezirk Laufen;5;VR APG Laufental;5;VR APG Laufental;285;2;2;0;13;9;4;0;4;289
2008;2791;Röschenz;1302;Bezirk Laufen;5;VR APG Laufental;5;VR APG Laufental;1796;17;13;4;105;82;23;0;27;1823
2008;2792;Wahlen;1302;Bezirk Laufen;5;VR APG Laufental;5;VR APG Laufental;1359;16;4;12;85;86;-1;0;11;1370
2008;2793;Zwingen;1302;Bezirk Laufen;5;VR APG Laufental;5;VR APG Laufental;2135;19;12;7;209;195;14;0;21;2156
2008;2821;Arisdorf;1303;Bezirk Liestal;6;VR Alters- und Pflegeregion Liestal;6;VR Alters- und Pflegeregion Liestal;1515;7;4;3;101;86;15;0;18;1533
2008;2822;Augst;1303;Bezirk Liestal;2;VR APG Rheintal;2;VR APG Rheintal;901;5;5;0;81;95;-14;0;-14;887
2008;2823;Bubendorf;1303;Bezirk Liestal;6;VR Alters- und Pflegeregion Liestal;6;VR Alters- und Pflegeregion Liestal;4369;38;21;17;288;311;-23;0;-6;4363
2008;2824;Frenkendorf;1303;Bezirk Liestal;6;VR Alters- und Pflegeregion Liestal;6;VR Alters- und Pflegeregion Liestal;6163;60;46;14;424;474;-50;1;-35;6128
2008;2825;Füllinsdorf;1303;Bezirk Liestal;6;VR Alters- und Pflegeregion Liestal;6;VR Alters- und Pflegeregion Liestal;4302;40;21;19;353;355;-2;0;17;4319
2008;2826;Giebenach;1303;Bezirk Liestal;2;VR APG Rheintal;2;VR APG Rheintal;979;10;4;6;76;85;-9;0;-3;976
2008;2827;Hersberg;1303;Bezirk Liestal;6;VR Alters- und Pflegeregion Liestal;6;VR Alters- und Pflegeregion Liestal;296;0;2;-2;36;23;13;0;11;307
2008;2828;Lausen;1303;Bezirk Liestal;6;VR Alters- und Pflegeregion Liestal;6;VR Alters- und Pflegeregion Liestal;4802;27;39;-12;396;346;50;0;38;4840
2008;2829;Liestal;1303;Bezirk Liestal;6;VR Alters- und Pflegeregion Liestal;6;VR Alters- und Pflegeregion Liestal;13422;148;118;30;1176;1169;7;-1;36;13458
2008;2830;Lupsingen;1303;Bezirk Liestal;6;VR Alters- und Pflegeregion Liestal;6;VR Alters- und Pflegeregion Liestal;1297;6;2;4;99;68;31;0;35;1332
2008;2831;Pratteln;1303;Bezirk Liestal;2;VR APG Rheintal;2;VR APG Rheintal;15070;160;116;44;1002;964;38;0;82;15152
2008;2832;Ramlinsburg;1303;Bezirk Liestal;10;VR Waldenburgertal plus;8;VR Waldenburgertal plus;717;7;2;5;44;52;-8;0;-3;714
2008;2833;Seltisberg;1303;Bezirk Liestal;6;VR Alters- und Pflegeregion Liestal;6;VR Alters- und Pflegeregion Liestal;1332;9;5;4;78;76;2;-1;5;1337
2008;2834;Ziefen;1303;Bezirk Liestal;6;VR Alters- und Pflegeregion Liestal;6;VR Alters- und Pflegeregion Liestal;1518;13;10;3;135;105;30;0;33;1551
2008;2841;Anwil;1304;Bezirk Sissach;9;VR Farnsberg plus;7;Planungsregion Oberbaselbiet;567;3;6;-3;35;26;9;0;6;573
2008;2842;Böckten;1304;Bezirk Sissach;7;VR Oberbaselbiet;7;Planungsregion Oberbaselbiet;763;10;5;5;67;57;10;0;15;778
2008;2843;Buckten;1304;Bezirk Sissach;8;VR Oberes Homburgertal;7;Planungsregion Oberbaselbiet;688;7;3;4;54;57;-3;0;1;689
2008;2844;Buus;1304;Bezirk Sissach;9;VR Farnsberg plus;7;Planungsregion Oberbaselbiet;962;4;6;-2;45;66;-21;0;-23;939
2008;2845;Diepflingen;1304;Bezirk Sissach;7;VR Oberbaselbiet;7;Planungsregion Oberbaselbiet;545;7;5;2;40;32;8;0;10;555
2008;2846;Gelterkinden;1304;Bezirk Sissach;7;VR Oberbaselbiet;7;Planungsregion Oberbaselbiet;5623;54;43;11;383;318;65;0;76;5699
2008;2847;Häfelfingen;1304;Bezirk Sissach;8;VR Oberes Homburgertal;7;Planungsregion Oberbaselbiet;271;2;1;1;17;21;-4;0;-3;268
2008;2848;Hemmiken;1304;Bezirk Sissach;9;VR Farnsberg plus;7;Planungsregion Oberbaselbiet;270;1;3;-2;17;12;5;0;3;273
2008;2849;Itingen;1304;Bezirk Sissach;7;VR Oberbaselbiet;7;Planungsregion Oberbaselbiet;1815;14;14;0;201;171;30;0;30;1845
2008;2850;Känerkinden;1304;Bezirk Sissach;8;VR Oberes Homburgertal;7;Planungsregion Oberbaselbiet;494;4;4;0;27;28;-1;0;-1;493
2008;2851;Kilchberg (BL);1304;Bezirk Sissach;9;VR Farnsberg plus;7;Planungsregion Oberbaselbiet;132;1;4;-3;7;5;2;0;-1;131
2008;2852;Läufelfingen;1304;Bezirk Sissach;8;VR Oberes Homburgertal;7;Planungsregion Oberbaselbiet;1274;14;16;-2;48;65;-17;0;-19;1255
2008;2853;Maisprach;1304;Bezirk Sissach;9;VR Farnsberg plus;7;Planungsregion Oberbaselbiet;956;5;4;1;72;96;-24;0;-23;933
2008;2854;Nusshof;1304;Bezirk Sissach;7;VR Oberbaselbiet;7;Planungsregion Oberbaselbiet;199;2;3;-1;17;6;11;0;10;209
2008;2855;Oltingen;1304;Bezirk Sissach;9;VR Farnsberg plus;7;Planungsregion Oberbaselbiet;417;2;4;-2;27;23;4;0;2;419
2008;2856;Ormalingen;1304;Bezirk Sissach;7;VR Oberbaselbiet;7;Planungsregion Oberbaselbiet;1885;12;13;-1;153;121;32;0;31;1916
2008;2857;Rickenbach (BL);1304;Bezirk Sissach;9;VR Farnsberg plus;7;Planungsregion Oberbaselbiet;556;5;3;2;24;36;-12;0;-10;546
2008;2858;Rothenfluh;1304;Bezirk Sissach;9;VR Farnsberg plus;7;Planungsregion Oberbaselbiet;726;7;9;-2;72;43;29;0;27;753
2008;2859;Rümlingen;1304;Bezirk Sissach;8;VR Oberes Homburgertal;7;Planungsregion Oberbaselbiet;347;2;1;1;49;28;21;0;22;369
2008;2860;Rünenberg;1304;Bezirk Sissach;9;VR Farnsberg plus;7;Planungsregion Oberbaselbiet;775;8;4;4;31;21;10;0;14;789
2008;2861;Sissach;1304;Bezirk Sissach;7;VR Oberbaselbiet;7;Planungsregion Oberbaselbiet;5845;65;51;14;712;441;271;0;285;6130
2008;2862;Tecknau;1304;Bezirk Sissach;7;VR Oberbaselbiet;7;Planungsregion Oberbaselbiet;813;12;3;9;76;64;12;0;21;834
2008;2863;Tenniken;1304;Bezirk Sissach;7;VR Oberbaselbiet;7;Planungsregion Oberbaselbiet;887;8;3;5;59;80;-21;0;-16;871
2008;2864;Thürnen;1304;Bezirk Sissach;7;VR Oberbaselbiet;7;Planungsregion Oberbaselbiet;1274;8;4;4;184;126;58;-1;61;1335
2008;2865;Wenslingen;1304;Bezirk Sissach;7;VR Oberbaselbiet;7;Planungsregion Oberbaselbiet;687;10;5;5;29;27;2;0;7;694
2008;2866;Wintersingen;1304;Bezirk Sissach;9;VR Farnsberg plus;7;Planungsregion Oberbaselbiet;619;2;2;0;33;35;-2;0;-2;617
2008;2867;Wittinsburg;1304;Bezirk Sissach;7;VR Oberbaselbiet;7;Planungsregion Oberbaselbiet;415;4;3;1;31;25;6;0;7;422
2008;2868;Zeglingen;1304;Bezirk Sissach;9;VR Farnsberg plus;7;Planungsregion Oberbaselbiet;458;7;7;0;19;15;4;0;4;462
2008;2869;Zunzgen;1304;Bezirk Sissach;7;VR Oberbaselbiet;7;Planungsregion Oberbaselbiet;2494;15;10;5;159;176;-17;0;-12;2482
2008;2881;Arboldswil;1305;Bezirk Waldenburg;10;VR Waldenburgertal plus;8;VR Waldenburgertal plus;510;8;2;6;31;24;7;0;13;523
2008;2882;Bennwil;1305;Bezirk Waldenburg;10;VR Waldenburgertal plus;8;VR Waldenburgertal plus;623;6;6;0;27;37;-10;0;-10;613
2008;2883;Bretzwil;1305;Bezirk Waldenburg;10;VR Waldenburgertal plus;8;VR Waldenburgertal plus;789;9;4;5;52;60;-8;0;-3;786
2008;2884;Diegten;1305;Bezirk Waldenburg;7;VR Oberbaselbiet;7;Planungsregion Oberbaselbiet;1562;18;10;8;122;123;-1;0;7;1569
2008;2885;Eptingen;1305;Bezirk Waldenburg;7;VR Oberbaselbiet;7;Planungsregion Oberbaselbiet;541;3;5;-2;25;44;-19;0;-21;520
2008;2886;Hölstein;1305;Bezirk Waldenburg;10;VR Waldenburgertal plus;8;VR Waldenburgertal plus;2342;16;20;-4;169;174;-5;0;-9;2333
2008;2887;Lampenberg;1305;Bezirk Waldenburg;10;VR Waldenburgertal plus;8;VR Waldenburgertal plus;505;3;8;-5;28;27;1;0;-4;501
2008;2888;Langenbruck;1305;Bezirk Waldenburg;10;VR Waldenburgertal plus;8;VR Waldenburgertal plus;989;10;13;-3;80;78;2;0;-1;988
2008;2889;Lauwil;1305;Bezirk Waldenburg;10;VR Waldenburgertal plus;8;VR Waldenburgertal plus;329;4;2;2;16;8;8;0;10;339
2008;2890;Liedertswil;1305;Bezirk Waldenburg;10;VR Waldenburgertal plus;8;VR Waldenburgertal plus;154;0;0;0;10;10;0;0;0;154
2008;2891;Niederdorf;1305;Bezirk Waldenburg;10;VR Waldenburgertal plus;8;VR Waldenburgertal plus;1798;16;16;0;97;99;-2;0;-2;1796
2008;2892;Oberdorf (BL);1305;Bezirk Waldenburg;10;VR Waldenburgertal plus;8;VR Waldenburgertal plus;2280;17;14;3;174;177;-3;0;0;2280
2008;2893;Reigoldswil;1305;Bezirk Waldenburg;10;VR Waldenburgertal plus;8;VR Waldenburgertal plus;1504;20;16;4;103;92;11;0;15;1519
2008;2894;Titterten;1305;Bezirk Waldenburg;10;VR Waldenburgertal plus;8;VR Waldenburgertal plus;413;6;6;0;33;24;9;0;9;422
2008;2895;Waldenburg;1305;Bezirk Waldenburg;10;VR Waldenburgertal plus;8;VR Waldenburgertal plus;1250;13;13;0;107;111;-4;0;-4;1246
2009;2761;Aesch (BL);1301;Bezirk Arlesheim;3;VR Alter Birsstadt;3;VR Alter Birsstadt;10105;108;81;27;828;725;103;0;130;10235
2009;2762;Allschwil;1301;Bezirk Arlesheim;1;VR Alter und Gesundheit ABS;1;VR Alter und Gesundheit ABS;19178;205;187;18;1414;1387;27;0;45;19223
2009;2763;Arlesheim;1301;Bezirk Arlesheim;3;VR Alter Birsstadt;3;VR Alter Birsstadt;8930;78;114;-36;643;583;60;0;24;8954
2009;2764;Biel-Benken;1301;Bezirk Arlesheim;4;VR BPA Leimental;4;VR BPA Leimental;3142;15;24;-9;186;196;-10;0;-19;3123
2009;2765;Binningen;1301;Bezirk Arlesheim;1;VR Alter und Gesundheit ABS;1;VR Alter und Gesundheit ABS;14533;141;149;-8;1274;1036;238;0;230;14763
2009;2766;Birsfelden;1301;Bezirk Arlesheim;2;VR APG Rheintal;2;VR APG Rheintal;10409;87;105;-18;793;751;42;0;24;10433
2009;2767;Bottmingen;1301;Bezirk Arlesheim;4;VR BPA Leimental;4;VR BPA Leimental;6004;67;55;12;631;534;97;0;109;6113
2009;2768;Ettingen;1301;Bezirk Arlesheim;4;VR BPA Leimental;4;VR BPA Leimental;4811;40;25;15;425;383;42;0;57;4868
2009;2769;Münchenstein;1301;Bezirk Arlesheim;3;VR Alter Birsstadt;3;VR Alter Birsstadt;11833;87;101;-14;932;910;22;0;8;11841
2009;2770;Muttenz;1301;Bezirk Arlesheim;2;VR APG Rheintal;2;VR APG Rheintal;17242;154;170;-16;1166;1061;105;-1;88;17330
2009;2771;Oberwil (BL);1301;Bezirk Arlesheim;4;VR BPA Leimental;4;VR BPA Leimental;10368;104;84;20;790;750;40;-1;59;10427
2009;2772;Pfeffingen;1301;Bezirk Arlesheim;3;VR Alter Birsstadt;3;VR Alter Birsstadt;2156;8;11;-3;204;155;49;-1;45;2201
2009;2773;Reinach (BL);1301;Bezirk Arlesheim;3;VR Alter Birsstadt;3;VR Alter Birsstadt;18868;147;155;-8;1237;1296;-59;0;-67;18801
2009;2774;Schönenbuch;1301;Bezirk Arlesheim;1;VR Alter und Gesundheit ABS;1;VR Alter und Gesundheit ABS;1434;19;7;12;80;79;1;-1;12;1446
2009;2775;Therwil;1301;Bezirk Arlesheim;4;VR BPA Leimental;4;VR BPA Leimental;9514;76;66;10;731;671;60;0;70;9584
2009;2781;Blauen;1302;Bezirk Laufen;5;VR APG Laufental;5;VR APG Laufental;694;5;5;0;30;34;-4;0;-4;690
2009;2782;Brislach;1302;Bezirk Laufen;5;VR APG Laufental;5;VR APG Laufental;1592;10;10;0;125;103;22;0;22;1614
2009;2783;Burg im Leimental;1302;Bezirk Laufen;4;VR BPA Leimental;4;VR BPA Leimental;230;5;1;4;24;18;6;0;10;240
2009;2784;Dittingen;1302;Bezirk Laufen;5;VR APG Laufental;5;VR APG Laufental;705;6;2;4;71;62;9;0;13;718
2009;2785;Duggingen;1302;Bezirk Laufen;3;VR Alter Birsstadt;3;VR Alter Birsstadt;1436;14;6;8;152;166;-14;0;-6;1430
2009;2786;Grellingen;1302;Bezirk Laufen;5;VR APG Laufental;5;VR APG Laufental;1715;25;14;11;208;203;5;0;16;1731
2009;2787;Laufen;1302;Bezirk Laufen;5;VR APG Laufental;5;VR APG Laufental;5229;50;38;12;398;371;27;0;39;5268
2009;2788;Liesberg;1302;Bezirk Laufen;5;VR APG Laufental;5;VR APG Laufental;1196;9;13;-4;81;59;22;0;18;1214
2009;2789;Nenzlingen;1302;Bezirk Laufen;5;VR APG Laufental;5;VR APG Laufental;420;2;2;0;25;16;9;0;9;429
2009;2790;Roggenburg;1302;Bezirk Laufen;5;VR APG Laufental;5;VR APG Laufental;289;0;1;-1;8;16;-8;0;-9;280
2009;2791;Röschenz;1302;Bezirk Laufen;5;VR APG Laufental;5;VR APG Laufental;1823;25;13;12;104;111;-7;0;5;1828
2009;2792;Wahlen;1302;Bezirk Laufen;5;VR APG Laufental;5;VR APG Laufental;1370;6;16;-10;78;85;-7;0;-17;1353
2009;2793;Zwingen;1302;Bezirk Laufen;5;VR APG Laufental;5;VR APG Laufental;2156;20;12;8;165;189;-24;0;-16;2140
2009;2821;Arisdorf;1303;Bezirk Liestal;6;VR Alters- und Pflegeregion Liestal;6;VR Alters- und Pflegeregion Liestal;1533;13;6;7;101;62;39;0;46;1579
2009;2822;Augst;1303;Bezirk Liestal;2;VR APG Rheintal;2;VR APG Rheintal;887;4;3;1;101;97;4;0;5;892
2009;2823;Bubendorf;1303;Bezirk Liestal;6;VR Alters- und Pflegeregion Liestal;6;VR Alters- und Pflegeregion Liestal;4363;29;23;6;318;277;41;0;47;4410
2009;2824;Frenkendorf;1303;Bezirk Liestal;6;VR Alters- und Pflegeregion Liestal;6;VR Alters- und Pflegeregion Liestal;6128;63;58;5;447;486;-39;0;-34;6094
2009;2825;Füllinsdorf;1303;Bezirk Liestal;6;VR Alters- und Pflegeregion Liestal;6;VR Alters- und Pflegeregion Liestal;4319;36;34;2;359;317;42;0;44;4363
2009;2826;Giebenach;1303;Bezirk Liestal;2;VR APG Rheintal;2;VR APG Rheintal;976;16;6;10;92;78;14;0;24;1000
2009;2827;Hersberg;1303;Bezirk Liestal;6;VR Alters- und Pflegeregion Liestal;6;VR Alters- und Pflegeregion Liestal;307;2;2;0;21;24;-3;0;-3;304
2009;2828;Lausen;1303;Bezirk Liestal;6;VR Alters- und Pflegeregion Liestal;6;VR Alters- und Pflegeregion Liestal;4840;44;29;15;350;347;3;0;18;4858
2009;2829;Liestal;1303;Bezirk Liestal;6;VR Alters- und Pflegeregion Liestal;6;VR Alters- und Pflegeregion Liestal;13458;139;102;37;1245;1189;56;0;93;13551
2009;2830;Lupsingen;1303;Bezirk Liestal;6;VR Alters- und Pflegeregion Liestal;6;VR Alters- und Pflegeregion Liestal;1332;9;10;-1;105;83;22;0;21;1353
2009;2831;Pratteln;1303;Bezirk Liestal;2;VR APG Rheintal;2;VR APG Rheintal;15152;140;139;1;1040;955;85;0;86;15238
2009;2832;Ramlinsburg;1303;Bezirk Liestal;10;VR Waldenburgertal plus;8;VR Waldenburgertal plus;714;3;3;0;47;58;-11;0;-11;703
2009;2833;Seltisberg;1303;Bezirk Liestal;6;VR Alters- und Pflegeregion Liestal;6;VR Alters- und Pflegeregion Liestal;1337;6;9;-3;77;87;-10;-36;-49;1288
2009;2834;Ziefen;1303;Bezirk Liestal;6;VR Alters- und Pflegeregion Liestal;6;VR Alters- und Pflegeregion Liestal;1551;14;12;2;95;104;-9;0;-7;1544
2009;2841;Anwil;1304;Bezirk Sissach;9;VR Farnsberg plus;7;Planungsregion Oberbaselbiet;573;7;2;5;25;40;-15;0;-10;563
2009;2842;Böckten;1304;Bezirk Sissach;7;VR Oberbaselbiet;7;Planungsregion Oberbaselbiet;778;6;3;3;49;50;-1;0;2;780
2009;2843;Buckten;1304;Bezirk Sissach;8;VR Oberes Homburgertal;7;Planungsregion Oberbaselbiet;689;6;6;0;63;54;9;0;9;698
2009;2844;Buus;1304;Bezirk Sissach;9;VR Farnsberg plus;7;Planungsregion Oberbaselbiet;939;7;8;-1;65;53;12;0;11;950
2009;2845;Diepflingen;1304;Bezirk Sissach;7;VR Oberbaselbiet;7;Planungsregion Oberbaselbiet;555;2;5;-3;60;36;24;0;21;576
2009;2846;Gelterkinden;1304;Bezirk Sissach;7;VR Oberbaselbiet;7;Planungsregion Oberbaselbiet;5699;54;46;8;385;356;29;0;37;5736
2009;2847;Häfelfingen;1304;Bezirk Sissach;8;VR Oberes Homburgertal;7;Planungsregion Oberbaselbiet;268;0;3;-3;20;15;5;0;2;270
2009;2848;Hemmiken;1304;Bezirk Sissach;9;VR Farnsberg plus;7;Planungsregion Oberbaselbiet;273;2;2;0;26;22;4;0;4;277
2009;2849;Itingen;1304;Bezirk Sissach;7;VR Oberbaselbiet;7;Planungsregion Oberbaselbiet;1845;15;14;1;154;132;22;0;23;1868
2009;2850;Känerkinden;1304;Bezirk Sissach;8;VR Oberes Homburgertal;7;Planungsregion Oberbaselbiet;493;6;3;3;35;35;0;-1;2;495
2009;2851;Kilchberg (BL);1304;Bezirk Sissach;9;VR Farnsberg plus;7;Planungsregion Oberbaselbiet;131;2;2;0;5;9;-4;0;-4;127
2009;2852;Läufelfingen;1304;Bezirk Sissach;8;VR Oberes Homburgertal;7;Planungsregion Oberbaselbiet;1255;13;9;4;67;56;11;0;15;1270
2009;2853;Maisprach;1304;Bezirk Sissach;9;VR Farnsberg plus;7;Planungsregion Oberbaselbiet;933;7;9;-2;76;55;21;0;19;952
2009;2854;Nusshof;1304;Bezirk Sissach;7;VR Oberbaselbiet;7;Planungsregion Oberbaselbiet;209;3;1;2;6;8;-2;0;0;209
2009;2855;Oltingen;1304;Bezirk Sissach;9;VR Farnsberg plus;7;Planungsregion Oberbaselbiet;419;6;2;4;32;20;12;0;16;435
2009;2856;Ormalingen;1304;Bezirk Sissach;7;VR Oberbaselbiet;7;Planungsregion Oberbaselbiet;1916;11;19;-8;158;134;24;0;16;1932
2009;2857;Rickenbach (BL);1304;Bezirk Sissach;9;VR Farnsberg plus;7;Planungsregion Oberbaselbiet;546;4;5;-1;47;37;10;-2;7;553
2009;2858;Rothenfluh;1304;Bezirk Sissach;9;VR Farnsberg plus;7;Planungsregion Oberbaselbiet;753;4;6;-2;70;55;15;0;13;766
2009;2859;Rümlingen;1304;Bezirk Sissach;8;VR Oberes Homburgertal;7;Planungsregion Oberbaselbiet;369;5;4;1;33;32;1;0;2;371
2009;2860;Rünenberg;1304;Bezirk Sissach;9;VR Farnsberg plus;7;Planungsregion Oberbaselbiet;789;5;5;0;39;36;3;0;3;792
2009;2861;Sissach;1304;Bezirk Sissach;7;VR Oberbaselbiet;7;Planungsregion Oberbaselbiet;6130;72;52;20;548;516;32;0;52;6182
2009;2862;Tecknau;1304;Bezirk Sissach;7;VR Oberbaselbiet;7;Planungsregion Oberbaselbiet;834;7;5;2;58;62;-4;0;-2;832
2009;2863;Tenniken;1304;Bezirk Sissach;7;VR Oberbaselbiet;7;Planungsregion Oberbaselbiet;871;6;3;3;75;63;12;0;15;886
2009;2864;Thürnen;1304;Bezirk Sissach;7;VR Oberbaselbiet;7;Planungsregion Oberbaselbiet;1335;12;12;0;192;164;28;0;28;1363
2009;2865;Wenslingen;1304;Bezirk Sissach;7;VR Oberbaselbiet;7;Planungsregion Oberbaselbiet;694;8;1;7;36;42;-6;0;1;695
2009;2866;Wintersingen;1304;Bezirk Sissach;9;VR Farnsberg plus;7;Planungsregion Oberbaselbiet;617;4;4;0;27;27;0;0;0;617
2009;2867;Wittinsburg;1304;Bezirk Sissach;7;VR Oberbaselbiet;7;Planungsregion Oberbaselbiet;422;6;5;1;26;33;-7;0;-6;416
2009;2868;Zeglingen;1304;Bezirk Sissach;9;VR Farnsberg plus;7;Planungsregion Oberbaselbiet;462;5;4;1;40;35;5;0;6;468
2009;2869;Zunzgen;1304;Bezirk Sissach;7;VR Oberbaselbiet;7;Planungsregion Oberbaselbiet;2482;27;21;6;185;172;13;0;19;2501
2009;2881;Arboldswil;1305;Bezirk Waldenburg;10;VR Waldenburgertal plus;8;VR Waldenburgertal plus;523;4;6;-2;29;26;3;-1;0;523
2009;2882;Bennwil;1305;Bezirk Waldenburg;10;VR Waldenburgertal plus;8;VR Waldenburgertal plus;613;9;2;7;45;31;14;0;21;634
2009;2883;Bretzwil;1305;Bezirk Waldenburg;10;VR Waldenburgertal plus;8;VR Waldenburgertal plus;786;10;4;6;55;61;-6;0;0;786
2009;2884;Diegten;1305;Bezirk Waldenburg;7;VR Oberbaselbiet;7;Planungsregion Oberbaselbiet;1569;10;10;0;120;112;8;0;8;1577
2009;2885;Eptingen;1305;Bezirk Waldenburg;7;VR Oberbaselbiet;7;Planungsregion Oberbaselbiet;520;4;6;-2;52;43;9;0;7;527
2009;2886;Hölstein;1305;Bezirk Waldenburg;10;VR Waldenburgertal plus;8;VR Waldenburgertal plus;2333;34;17;17;170;172;-2;0;15;2348
2009;2887;Lampenberg;1305;Bezirk Waldenburg;10;VR Waldenburgertal plus;8;VR Waldenburgertal plus;501;3;1;2;30;26;4;0;6;507
2009;2888;Langenbruck;1305;Bezirk Waldenburg;10;VR Waldenburgertal plus;8;VR Waldenburgertal plus;988;8;8;0;113;104;9;0;9;997
2009;2889;Lauwil;1305;Bezirk Waldenburg;10;VR Waldenburgertal plus;8;VR Waldenburgertal plus;339;4;3;1;14;23;-9;0;-8;331
2009;2890;Liedertswil;1305;Bezirk Waldenburg;10;VR Waldenburgertal plus;8;VR Waldenburgertal plus;154;0;1;-1;21;12;9;0;8;162
2009;2891;Niederdorf;1305;Bezirk Waldenburg;10;VR Waldenburgertal plus;8;VR Waldenburgertal plus;1796;13;15;-2;132;125;7;0;5;1801
2009;2892;Oberdorf (BL);1305;Bezirk Waldenburg;10;VR Waldenburgertal plus;8;VR Waldenburgertal plus;2280;16;16;0;141;144;-3;0;-3;2277
2009;2893;Reigoldswil;1305;Bezirk Waldenburg;10;VR Waldenburgertal plus;8;VR Waldenburgertal plus;1519;5;12;-7;155;106;49;0;42;1561
2009;2894;Titterten;1305;Bezirk Waldenburg;10;VR Waldenburgertal plus;8;VR Waldenburgertal plus;422;2;5;-3;23;42;-19;0;-22;400
2009;2895;Waldenburg;1305;Bezirk Waldenburg;10;VR Waldenburgertal plus;8;VR Waldenburgertal plus;1246;11;8;3;103;144;-41;0;-38;1208
2010;2761;Aesch (BL);1301;Bezirk Arlesheim;3;VR Alter Birsstadt;3;VR Alter Birsstadt;10235;87;60;27;732;739;-7;0;20;10255
2010;2762;Allschwil;1301;Bezirk Arlesheim;1;VR Alter und Gesundheit ABS;1;VR Alter und Gesundheit ABS;19223;195;165;30;1600;1412;188;-1;217;19440
2010;2763;Arlesheim;1301;Bezirk Arlesheim;3;VR Alter Birsstadt;3;VR Alter Birsstadt;8954;84;80;4;668;571;97;0;101;9055
2010;2764;Biel-Benken;1301;Bezirk Arlesheim;4;VR BPA Leimental;4;VR BPA Leimental;3123;24;23;1;219;224;-5;0;-4;3119
2010;2765;Binningen;1301;Bezirk Arlesheim;1;VR Alter und Gesundheit ABS;1;VR Alter und Gesundheit ABS;14763;149;124;25;1093;1098;-5;0;20;14783
2010;2766;Birsfelden;1301;Bezirk Arlesheim;2;VR APG Rheintal;2;VR APG Rheintal;10433;90;124;-34;662;655;7;-1;-28;10405
2010;2767;Bottmingen;1301;Bezirk Arlesheim;4;VR BPA Leimental;4;VR BPA Leimental;6113;63;55;8;542;511;31;0;39;6152
2010;2768;Ettingen;1301;Bezirk Arlesheim;4;VR BPA Leimental;4;VR BPA Leimental;4868;35;32;3;315;338;-23;0;-20;4848
2010;2769;Münchenstein;1301;Bezirk Arlesheim;3;VR Alter Birsstadt;3;VR Alter Birsstadt;11841;93;111;-18;849;814;35;0;17;11858
2010;2770;Muttenz;1301;Bezirk Arlesheim;2;VR APG Rheintal;2;VR APG Rheintal;17330;159;168;-9;999;987;12;0;3;17333
2010;2771;Oberwil (BL);1301;Bezirk Arlesheim;4;VR BPA Leimental;4;VR BPA Leimental;10427;96;89;7;844;743;101;0;108;10535
2010;2772;Pfeffingen;1301;Bezirk Arlesheim;3;VR Alter Birsstadt;3;VR Alter Birsstadt;2201;9;10;-1;140;154;-14;0;-15;2186
2010;2773;Reinach (BL);1301;Bezirk Arlesheim;3;VR Alter Birsstadt;3;VR Alter Birsstadt;18801;135;171;-36;1253;1231;22;0;-14;18787
2010;2774;Schönenbuch;1301;Bezirk Arlesheim;1;VR Alter und Gesundheit ABS;1;VR Alter und Gesundheit ABS;1446;15;5;10;83;107;-24;0;-14;1432
2010;2775;Therwil;1301;Bezirk Arlesheim;4;VR BPA Leimental;4;VR BPA Leimental;9584;71;73;-2;674;632;42;0;40;9624
2010;2781;Blauen;1302;Bezirk Laufen;5;VR APG Laufental;5;VR APG Laufental;690;9;3;6;34;45;-11;0;-5;685
2010;2782;Brislach;1302;Bezirk Laufen;5;VR APG Laufental;5;VR APG Laufental;1614;10;11;-1;87;90;-3;0;-4;1610
2010;2783;Burg im Leimental;1302;Bezirk Laufen;4;VR BPA Leimental;4;VR BPA Leimental;240;4;2;2;15;12;3;0;5;245
2010;2784;Dittingen;1302;Bezirk Laufen;5;VR APG Laufental;5;VR APG Laufental;718;6;5;1;76;48;28;0;29;747
2010;2785;Duggingen;1302;Bezirk Laufen;3;VR Alter Birsstadt;3;VR Alter Birsstadt;1430;11;6;5;169;117;52;0;57;1487
2010;2786;Grellingen;1302;Bezirk Laufen;5;VR APG Laufental;5;VR APG Laufental;1731;12;15;-3;159;137;22;0;19;1750
2010;2787;Laufen;1302;Bezirk Laufen;5;VR APG Laufental;5;VR APG Laufental;5268;51;37;14;328;379;-51;0;-37;5231
2010;2788;Liesberg;1302;Bezirk Laufen;5;VR APG Laufental;5;VR APG Laufental;1214;10;15;-5;76;83;-7;0;-12;1202
2010;2789;Nenzlingen;1302;Bezirk Laufen;5;VR APG Laufental;5;VR APG Laufental;429;3;3;0;22;18;4;0;4;433
2010;2790;Roggenburg;1302;Bezirk Laufen;5;VR APG Laufental;5;VR APG Laufental;280;7;1;6;15;13;2;0;8;288
2010;2791;Röschenz;1302;Bezirk Laufen;5;VR APG Laufental;5;VR APG Laufental;1828;13;8;5;99;110;-11;0;-6;1822
2010;2792;Wahlen;1302;Bezirk Laufen;5;VR APG Laufental;5;VR APG Laufental;1353;7;10;-3;74;83;-9;0;-12;1341
2010;2793;Zwingen;1302;Bezirk Laufen;5;VR APG Laufental;5;VR APG Laufental;2140;24;9;15;214;185;29;0;44;2184
2010;2821;Arisdorf;1303;Bezirk Liestal;6;VR Alters- und Pflegeregion Liestal;6;VR Alters- und Pflegeregion Liestal;1579;11;9;2;86;91;-5;0;-3;1576
2010;2822;Augst;1303;Bezirk Liestal;2;VR APG Rheintal;2;VR APG Rheintal;892;4;8;-4;78;88;-10;0;-14;878
2010;2823;Bubendorf;1303;Bezirk Liestal;6;VR Alters- und Pflegeregion Liestal;6;VR Alters- und Pflegeregion Liestal;4410;39;26;13;223;274;-51;0;-38;4372
2010;2824;Frenkendorf;1303;Bezirk Liestal;6;VR Alters- und Pflegeregion Liestal;6;VR Alters- und Pflegeregion Liestal;6094;58;49;9;466;417;49;0;58;6152
2010;2825;Füllinsdorf;1303;Bezirk Liestal;6;VR Alters- und Pflegeregion Liestal;6;VR Alters- und Pflegeregion Liestal;4363;47;42;5;355;383;-28;0;-23;4340
2010;2826;Giebenach;1303;Bezirk Liestal;2;VR APG Rheintal;2;VR APG Rheintal;1000;7;6;1;77;89;-12;0;-11;989
2010;2827;Hersberg;1303;Bezirk Liestal;6;VR Alters- und Pflegeregion Liestal;6;VR Alters- und Pflegeregion Liestal;304;4;0;4;16;14;2;0;6;310
2010;2828;Lausen;1303;Bezirk Liestal;6;VR Alters- und Pflegeregion Liestal;6;VR Alters- und Pflegeregion Liestal;4858;38;32;6;364;353;11;0;17;4875
2010;2829;Liestal;1303;Bezirk Liestal;6;VR Alters- und Pflegeregion Liestal;6;VR Alters- und Pflegeregion Liestal;13551;150;96;54;1117;1056;61;0;115;13666
2010;2830;Lupsingen;1303;Bezirk Liestal;6;VR Alters- und Pflegeregion Liestal;6;VR Alters- und Pflegeregion Liestal;1353;12;11;1;79;78;1;0;2;1355
2010;2831;Pratteln;1303;Bezirk Liestal;2;VR APG Rheintal;2;VR APG Rheintal;15238;154;127;27;1042;941;101;0;128;15366
2010;2832;Ramlinsburg;1303;Bezirk Liestal;10;VR Waldenburgertal plus;8;VR Waldenburgertal plus;703;7;8;-1;47;59;-12;0;-13;690
2010;2833;Seltisberg;1303;Bezirk Liestal;6;VR Alters- und Pflegeregion Liestal;6;VR Alters- und Pflegeregion Liestal;1288;8;8;0;68;69;-1;0;-1;1287
2010;2834;Ziefen;1303;Bezirk Liestal;6;VR Alters- und Pflegeregion Liestal;6;VR Alters- und Pflegeregion Liestal;1544;12;5;7;104;80;24;0;31;1575
2010;2841;Anwil;1304;Bezirk Sissach;9;VR Farnsberg plus;7;Planungsregion Oberbaselbiet;563;9;5;4;41;20;21;0;25;588
2010;2842;Böckten;1304;Bezirk Sissach;7;VR Oberbaselbiet;7;Planungsregion Oberbaselbiet;780;8;4;4;75;73;2;0;6;786
2010;2843;Buckten;1304;Bezirk Sissach;8;VR Oberes Homburgertal;7;Planungsregion Oberbaselbiet;698;4;8;-4;52;49;3;0;-1;697
2010;2844;Buus;1304;Bezirk Sissach;9;VR Farnsberg plus;7;Planungsregion Oberbaselbiet;950;6;12;-6;62;56;6;0;0;950
2010;2845;Diepflingen;1304;Bezirk Sissach;7;VR Oberbaselbiet;7;Planungsregion Oberbaselbiet;576;3;4;-1;48;47;1;0;0;576
2010;2846;Gelterkinden;1304;Bezirk Sissach;7;VR Oberbaselbiet;7;Planungsregion Oberbaselbiet;5736;51;54;-3;340;356;-16;0;-19;5717
2010;2847;Häfelfingen;1304;Bezirk Sissach;8;VR Oberes Homburgertal;7;Planungsregion Oberbaselbiet;270;1;1;0;13;25;-12;0;-12;258
2010;2848;Hemmiken;1304;Bezirk Sissach;9;VR Farnsberg plus;7;Planungsregion Oberbaselbiet;277;1;7;-6;15;16;-1;0;-7;270
2010;2849;Itingen;1304;Bezirk Sissach;7;VR Oberbaselbiet;7;Planungsregion Oberbaselbiet;1868;19;12;7;243;147;96;0;103;1971
2010;2850;Känerkinden;1304;Bezirk Sissach;8;VR Oberes Homburgertal;7;Planungsregion Oberbaselbiet;495;1;3;-2;39;33;6;0;4;499
2010;2851;Kilchberg (BL);1304;Bezirk Sissach;9;VR Farnsberg plus;7;Planungsregion Oberbaselbiet;127;1;0;1;17;5;12;0;13;140
2010;2852;Läufelfingen;1304;Bezirk Sissach;8;VR Oberes Homburgertal;7;Planungsregion Oberbaselbiet;1270;10;14;-4;79;76;3;0;-1;1269
2010;2853;Maisprach;1304;Bezirk Sissach;9;VR Farnsberg plus;7;Planungsregion Oberbaselbiet;952;7;6;1;78;76;2;0;3;955
2010;2854;Nusshof;1304;Bezirk Sissach;7;VR Oberbaselbiet;7;Planungsregion Oberbaselbiet;209;1;2;-1;21;13;8;0;7;216
2010;2855;Oltingen;1304;Bezirk Sissach;9;VR Farnsberg plus;7;Planungsregion Oberbaselbiet;435;2;5;-3;35;19;16;0;13;448
2010;2856;Ormalingen;1304;Bezirk Sissach;7;VR Oberbaselbiet;7;Planungsregion Oberbaselbiet;1932;24;19;5;168;158;10;0;15;1947
2010;2857;Rickenbach (BL);1304;Bezirk Sissach;9;VR Farnsberg plus;7;Planungsregion Oberbaselbiet;553;8;3;5;24;33;-9;0;-4;549
2010;2858;Rothenfluh;1304;Bezirk Sissach;9;VR Farnsberg plus;7;Planungsregion Oberbaselbiet;766;8;5;3;63;78;-15;0;-12;754
2010;2859;Rümlingen;1304;Bezirk Sissach;8;VR Oberes Homburgertal;7;Planungsregion Oberbaselbiet;371;3;5;-2;38;40;-2;0;-4;367
2010;2860;Rünenberg;1304;Bezirk Sissach;9;VR Farnsberg plus;7;Planungsregion Oberbaselbiet;792;7;3;4;32;38;-6;0;-2;790
2010;2861;Sissach;1304;Bezirk Sissach;7;VR Oberbaselbiet;7;Planungsregion Oberbaselbiet;6182;86;49;37;529;477;52;0;89;6271
2010;2862;Tecknau;1304;Bezirk Sissach;7;VR Oberbaselbiet;7;Planungsregion Oberbaselbiet;832;9;5;4;64;67;-3;0;1;833
2010;2863;Tenniken;1304;Bezirk Sissach;7;VR Oberbaselbiet;7;Planungsregion Oberbaselbiet;886;8;7;1;53;70;-17;0;-16;870
2010;2864;Thürnen;1304;Bezirk Sissach;7;VR Oberbaselbiet;7;Planungsregion Oberbaselbiet;1363;11;3;8;110;105;5;0;13;1376
2010;2865;Wenslingen;1304;Bezirk Sissach;7;VR Oberbaselbiet;7;Planungsregion Oberbaselbiet;695;5;4;1;34;40;-6;0;-5;690
2010;2866;Wintersingen;1304;Bezirk Sissach;9;VR Farnsberg plus;7;Planungsregion Oberbaselbiet;617;6;5;1;39;22;17;0;18;635
2010;2867;Wittinsburg;1304;Bezirk Sissach;7;VR Oberbaselbiet;7;Planungsregion Oberbaselbiet;416;4;2;2;13;15;-2;0;0;416
2010;2868;Zeglingen;1304;Bezirk Sissach;9;VR Farnsberg plus;7;Planungsregion Oberbaselbiet;468;4;6;-2;16;25;-9;0;-11;457
2010;2869;Zunzgen;1304;Bezirk Sissach;7;VR Oberbaselbiet;7;Planungsregion Oberbaselbiet;2501;24;19;5;198;171;27;0;32;2533
2010;2881;Arboldswil;1305;Bezirk Waldenburg;10;VR Waldenburgertal plus;8;VR Waldenburgertal plus;523;4;3;1;35;43;-8;-1;-8;515
2010;2882;Bennwil;1305;Bezirk Waldenburg;10;VR Waldenburgertal plus;8;VR Waldenburgertal plus;634;10;7;3;47;46;1;0;4;638
2010;2883;Bretzwil;1305;Bezirk Waldenburg;10;VR Waldenburgertal plus;8;VR Waldenburgertal plus;786;7;4;3;45;44;1;0;4;790
2010;2884;Diegten;1305;Bezirk Waldenburg;7;VR Oberbaselbiet;7;Planungsregion Oberbaselbiet;1577;15;9;6;102;117;-15;0;-9;1568
2010;2885;Eptingen;1305;Bezirk Waldenburg;7;VR Oberbaselbiet;7;Planungsregion Oberbaselbiet;527;9;4;5;55;51;4;0;9;536
2010;2886;Hölstein;1305;Bezirk Waldenburg;10;VR Waldenburgertal plus;8;VR Waldenburgertal plus;2348;23;10;13;198;228;-30;-2;-19;2329
2010;2887;Lampenberg;1305;Bezirk Waldenburg;10;VR Waldenburgertal plus;8;VR Waldenburgertal plus;507;9;3;6;26;22;4;0;10;517
2010;2888;Langenbruck;1305;Bezirk Waldenburg;10;VR Waldenburgertal plus;8;VR Waldenburgertal plus;997;7;6;1;114;118;-4;0;-3;994
2010;2889;Lauwil;1305;Bezirk Waldenburg;10;VR Waldenburgertal plus;8;VR Waldenburgertal plus;331;2;6;-4;25;19;6;1;3;334
2010;2890;Liedertswil;1305;Bezirk Waldenburg;10;VR Waldenburgertal plus;8;VR Waldenburgertal plus;162;2;0;2;8;12;-4;0;-2;160
2010;2891;Niederdorf;1305;Bezirk Waldenburg;10;VR Waldenburgertal plus;8;VR Waldenburgertal plus;1801;23;22;1;115;125;-10;0;-9;1792
2010;2892;Oberdorf (BL);1305;Bezirk Waldenburg;10;VR Waldenburgertal plus;8;VR Waldenburgertal plus;2277;16;22;-6;169;156;13;0;7;2284
2010;2893;Reigoldswil;1305;Bezirk Waldenburg;10;VR Waldenburgertal plus;8;VR Waldenburgertal plus;1561;16;20;-4;127;118;9;0;5;1566
2010;2894;Titterten;1305;Bezirk Waldenburg;10;VR Waldenburgertal plus;8;VR Waldenburgertal plus;400;2;4;-2;33;15;18;0;16;416
2010;2895;Waldenburg;1305;Bezirk Waldenburg;10;VR Waldenburgertal plus;8;VR Waldenburgertal plus;1208;12;12;0;128;115;13;0;13;1221
2011;2761;Aesch (BL);1301;Bezirk Arlesheim;3;VR Alter Birsstadt;3;VR Alter Birsstadt;10255;95;69;26;789;758;31;0;57;10312
2011;2762;Allschwil;1301;Bezirk Arlesheim;1;VR Alter und Gesundheit ABS;1;VR Alter und Gesundheit ABS;19440;212;211;1;1838;1361;477;-1;477;19917
2011;2763;Arlesheim;1301;Bezirk Arlesheim;3;VR Alter Birsstadt;3;VR Alter Birsstadt;9055;62;110;-48;688;641;47;0;-1;9054
2011;2764;Biel-Benken;1301;Bezirk Arlesheim;4;VR BPA Leimental;4;VR BPA Leimental;3119;15;12;3;221;186;35;-2;36;3155
2011;2765;Binningen;1301;Bezirk Arlesheim;1;VR Alter und Gesundheit ABS;1;VR Alter und Gesundheit ABS;14783;151;148;3;1228;1170;58;-1;60;14843
2011;2766;Birsfelden;1301;Bezirk Arlesheim;2;VR APG Rheintal;2;VR APG Rheintal;10405;103;106;-3;769;777;-8;-2;-13;10392
2011;2767;Bottmingen;1301;Bezirk Arlesheim;4;VR BPA Leimental;4;VR BPA Leimental;6152;60;54;6;542;544;-2;0;4;6156
2011;2768;Ettingen;1301;Bezirk Arlesheim;4;VR BPA Leimental;4;VR BPA Leimental;4848;48;38;10;411;368;43;-1;52;4900
2011;2769;Münchenstein;1301;Bezirk Arlesheim;3;VR Alter Birsstadt;3;VR Alter Birsstadt;11858;94;88;6;812;860;-48;-1;-43;11815
2011;2770;Muttenz;1301;Bezirk Arlesheim;2;VR APG Rheintal;2;VR APG Rheintal;17333;131;174;-43;1130;1026;104;-2;59;17392
2011;2771;Oberwil (BL);1301;Bezirk Arlesheim;4;VR BPA Leimental;4;VR BPA Leimental;10535;86;67;19;828;745;83;-1;101;10636
2011;2772;Pfeffingen;1301;Bezirk Arlesheim;3;VR Alter Birsstadt;3;VR Alter Birsstadt;2186;19;11;8;154;151;3;0;11;2197
2011;2773;Reinach (BL);1301;Bezirk Arlesheim;3;VR Alter Birsstadt;3;VR Alter Birsstadt;18787;145;164;-19;1256;1272;-16;0;-35;18752
2011;2774;Schönenbuch;1301;Bezirk Arlesheim;1;VR Alter und Gesundheit ABS;1;VR Alter und Gesundheit ABS;1432;11;9;2;80;67;13;0;15;1447
2011;2775;Therwil;1301;Bezirk Arlesheim;4;VR BPA Leimental;4;VR BPA Leimental;9624;79;61;18;825;661;164;-1;181;9805
2011;2781;Blauen;1302;Bezirk Laufen;5;VR APG Laufental;5;VR APG Laufental;685;7;5;2;40;35;5;0;7;692
2011;2782;Brislach;1302;Bezirk Laufen;5;VR APG Laufental;5;VR APG Laufental;1610;10;12;-2;79;75;4;-1;1;1611
2011;2783;Burg im Leimental;1302;Bezirk Laufen;4;VR BPA Leimental;4;VR BPA Leimental;245;4;0;4;31;18;13;0;17;262
2011;2784;Dittingen;1302;Bezirk Laufen;5;VR APG Laufental;5;VR APG Laufental;747;10;8;2;55;65;-10;-1;-9;738
2011;2785;Duggingen;1302;Bezirk Laufen;3;VR Alter Birsstadt;3;VR Alter Birsstadt;1487;11;6;5;154;168;-14;0;-9;1478
2011;2786;Grellingen;1302;Bezirk Laufen;5;VR APG Laufental;5;VR APG Laufental;1750;17;13;4;143;136;7;-1;10;1760
2011;2787;Laufen;1302;Bezirk Laufen;5;VR APG Laufental;5;VR APG Laufental;5231;40;37;3;423;351;72;0;75;5306
2011;2788;Liesberg;1302;Bezirk Laufen;5;VR APG Laufental;5;VR APG Laufental;1202;11;12;-1;76;89;-13;0;-14;1188
2011;2789;Nenzlingen;1302;Bezirk Laufen;5;VR APG Laufental;5;VR APG Laufental;433;4;4;0;27;11;16;0;16;449
2011;2790;Roggenburg;1302;Bezirk Laufen;5;VR APG Laufental;5;VR APG Laufental;288;1;4;-3;26;30;-4;0;-7;281
2011;2791;Röschenz;1302;Bezirk Laufen;5;VR APG Laufental;5;VR APG Laufental;1822;19;11;8;118;111;7;0;15;1837
2011;2792;Wahlen;1302;Bezirk Laufen;5;VR APG Laufental;5;VR APG Laufental;1341;9;18;-9;74;80;-6;0;-15;1326
2011;2793;Zwingen;1302;Bezirk Laufen;5;VR APG Laufental;5;VR APG Laufental;2184;16;9;7;179;199;-20;0;-13;2171
2011;2821;Arisdorf;1303;Bezirk Liestal;6;VR Alters- und Pflegeregion Liestal;6;VR Alters- und Pflegeregion Liestal;1576;13;9;4;122;100;22;0;26;1602
2011;2822;Augst;1303;Bezirk Liestal;2;VR APG Rheintal;2;VR APG Rheintal;878;3;14;-11;74;91;-17;0;-28;850
2011;2823;Bubendorf;1303;Bezirk Liestal;6;VR Alters- und Pflegeregion Liestal;6;VR Alters- und Pflegeregion Liestal;4372;39;16;23;272;247;25;-1;47;4419
2011;2824;Frenkendorf;1303;Bezirk Liestal;6;VR Alters- und Pflegeregion Liestal;6;VR Alters- und Pflegeregion Liestal;6152;54;39;15;522;447;75;0;90;6242
2011;2825;Füllinsdorf;1303;Bezirk Liestal;6;VR Alters- und Pflegeregion Liestal;6;VR Alters- und Pflegeregion Liestal;4340;37;31;6;345;339;6;0;12;4352
2011;2826;Giebenach;1303;Bezirk Liestal;2;VR APG Rheintal;2;VR APG Rheintal;989;9;5;4;66;88;-22;0;-18;971
2011;2827;Hersberg;1303;Bezirk Liestal;6;VR Alters- und Pflegeregion Liestal;6;VR Alters- und Pflegeregion Liestal;310;6;2;4;24;17;7;0;11;321
2011;2828;Lausen;1303;Bezirk Liestal;6;VR Alters- und Pflegeregion Liestal;6;VR Alters- und Pflegeregion Liestal;4875;38;27;11;365;393;-28;0;-17;4858
2011;2829;Liestal;1303;Bezirk Liestal;6;VR Alters- und Pflegeregion Liestal;6;VR Alters- und Pflegeregion Liestal;13666;139;97;42;1085;1121;-36;0;6;13672
2011;2830;Lupsingen;1303;Bezirk Liestal;6;VR Alters- und Pflegeregion Liestal;6;VR Alters- und Pflegeregion Liestal;1355;10;10;0;92;87;5;0;5;1360
2011;2831;Pratteln;1303;Bezirk Liestal;2;VR APG Rheintal;2;VR APG Rheintal;15366;163;117;46;932;1036;-104;-3;-61;15305
2011;2832;Ramlinsburg;1303;Bezirk Liestal;10;VR Waldenburgertal plus;8;VR Waldenburgertal plus;690;6;3;3;47;51;-4;0;-1;689
2011;2833;Seltisberg;1303;Bezirk Liestal;6;VR Alters- und Pflegeregion Liestal;6;VR Alters- und Pflegeregion Liestal;1287;7;10;-3;65;85;-20;0;-23;1264
2011;2834;Ziefen;1303;Bezirk Liestal;6;VR Alters- und Pflegeregion Liestal;6;VR Alters- und Pflegeregion Liestal;1575;14;13;1;94;93;1;0;2;1577
2011;2841;Anwil;1304;Bezirk Sissach;9;VR Farnsberg plus;7;Planungsregion Oberbaselbiet;588;11;3;8;24;40;-16;0;-8;580
2011;2842;Böckten;1304;Bezirk Sissach;7;VR Oberbaselbiet;7;Planungsregion Oberbaselbiet;786;7;6;1;56;48;8;0;9;795
2011;2843;Buckten;1304;Bezirk Sissach;8;VR Oberes Homburgertal;7;Planungsregion Oberbaselbiet;697;4;4;0;64;73;-9;0;-9;688
2011;2844;Buus;1304;Bezirk Sissach;9;VR Farnsberg plus;7;Planungsregion Oberbaselbiet;950;4;5;-1;59;56;3;0;2;952
2011;2845;Diepflingen;1304;Bezirk Sissach;7;VR Oberbaselbiet;7;Planungsregion Oberbaselbiet;576;2;4;-2;55;42;13;0;11;587
2011;2846;Gelterkinden;1304;Bezirk Sissach;7;VR Oberbaselbiet;7;Planungsregion Oberbaselbiet;5717;42;53;-11;399;320;79;0;68;5785
2011;2847;Häfelfingen;1304;Bezirk Sissach;8;VR Oberes Homburgertal;7;Planungsregion Oberbaselbiet;258;3;2;1;8;2;6;-1;6;264
2011;2848;Hemmiken;1304;Bezirk Sissach;9;VR Farnsberg plus;7;Planungsregion Oberbaselbiet;270;2;1;1;17;14;3;0;4;274
2011;2849;Itingen;1304;Bezirk Sissach;7;VR Oberbaselbiet;7;Planungsregion Oberbaselbiet;1971;20;14;6;167;152;15;0;21;1992
2011;2850;Känerkinden;1304;Bezirk Sissach;8;VR Oberes Homburgertal;7;Planungsregion Oberbaselbiet;499;3;4;-1;22;23;-1;0;-2;497
2011;2851;Kilchberg (BL);1304;Bezirk Sissach;9;VR Farnsberg plus;7;Planungsregion Oberbaselbiet;140;2;1;1;15;5;10;0;11;151
2011;2852;Läufelfingen;1304;Bezirk Sissach;8;VR Oberes Homburgertal;7;Planungsregion Oberbaselbiet;1269;15;8;7;70;73;-3;0;4;1273
2011;2853;Maisprach;1304;Bezirk Sissach;9;VR Farnsberg plus;7;Planungsregion Oberbaselbiet;955;3;5;-2;86;86;0;0;-2;953
2011;2854;Nusshof;1304;Bezirk Sissach;7;VR Oberbaselbiet;7;Planungsregion Oberbaselbiet;216;4;0;4;27;13;14;0;18;234
2011;2855;Oltingen;1304;Bezirk Sissach;9;VR Farnsberg plus;7;Planungsregion Oberbaselbiet;448;8;4;4;44;30;14;0;18;466
2011;2856;Ormalingen;1304;Bezirk Sissach;7;VR Oberbaselbiet;7;Planungsregion Oberbaselbiet;1947;17;14;3;151;140;11;0;14;1961
2011;2857;Rickenbach (BL);1304;Bezirk Sissach;9;VR Farnsberg plus;7;Planungsregion Oberbaselbiet;549;5;5;0;53;32;21;0;21;570
2011;2858;Rothenfluh;1304;Bezirk Sissach;9;VR Farnsberg plus;7;Planungsregion Oberbaselbiet;754;11;6;5;48;47;1;0;6;760
2011;2859;Rümlingen;1304;Bezirk Sissach;8;VR Oberes Homburgertal;7;Planungsregion Oberbaselbiet;367;3;6;-3;43;34;9;0;6;373
2011;2860;Rünenberg;1304;Bezirk Sissach;9;VR Farnsberg plus;7;Planungsregion Oberbaselbiet;790;3;13;-10;32;45;-13;0;-23;767
2011;2861;Sissach;1304;Bezirk Sissach;7;VR Oberbaselbiet;7;Planungsregion Oberbaselbiet;6271;75;59;16;508;524;-16;0;0;6271
2011;2862;Tecknau;1304;Bezirk Sissach;7;VR Oberbaselbiet;7;Planungsregion Oberbaselbiet;833;11;3;8;61;67;-6;-1;1;834
2011;2863;Tenniken;1304;Bezirk Sissach;7;VR Oberbaselbiet;7;Planungsregion Oberbaselbiet;870;8;3;5;72;69;3;0;8;878
2011;2864;Thürnen;1304;Bezirk Sissach;7;VR Oberbaselbiet;7;Planungsregion Oberbaselbiet;1376;16;14;2;132;117;15;0;17;1393
2011;2865;Wenslingen;1304;Bezirk Sissach;7;VR Oberbaselbiet;7;Planungsregion Oberbaselbiet;690;8;1;7;39;25;14;0;21;711
2011;2866;Wintersingen;1304;Bezirk Sissach;9;VR Farnsberg plus;7;Planungsregion Oberbaselbiet;635;3;2;1;38;33;5;0;6;641
2011;2867;Wittinsburg;1304;Bezirk Sissach;7;VR Oberbaselbiet;7;Planungsregion Oberbaselbiet;416;3;3;0;16;16;0;0;0;416
2011;2868;Zeglingen;1304;Bezirk Sissach;9;VR Farnsberg plus;7;Planungsregion Oberbaselbiet;457;6;5;1;21;23;-2;0;-1;456
2011;2869;Zunzgen;1304;Bezirk Sissach;7;VR Oberbaselbiet;7;Planungsregion Oberbaselbiet;2533;27;20;7;160;201;-41;0;-34;2499
2011;2881;Arboldswil;1305;Bezirk Waldenburg;10;VR Waldenburgertal plus;8;VR Waldenburgertal plus;515;5;3;2;37;20;17;0;19;534
2011;2882;Bennwil;1305;Bezirk Waldenburg;10;VR Waldenburgertal plus;8;VR Waldenburgertal plus;638;10;2;8;43;52;-9;0;-1;637
2011;2883;Bretzwil;1305;Bezirk Waldenburg;10;VR Waldenburgertal plus;8;VR Waldenburgertal plus;790;8;8;0;41;51;-10;0;-10;780
2011;2884;Diegten;1305;Bezirk Waldenburg;7;VR Oberbaselbiet;7;Planungsregion Oberbaselbiet;1568;13;10;3;125;140;-15;0;-12;1556
2011;2885;Eptingen;1305;Bezirk Waldenburg;7;VR Oberbaselbiet;7;Planungsregion Oberbaselbiet;536;8;7;1;39;50;-11;0;-10;526
2011;2886;Hölstein;1305;Bezirk Waldenburg;10;VR Waldenburgertal plus;8;VR Waldenburgertal plus;2329;29;20;9;236;200;36;0;45;2374
2011;2887;Lampenberg;1305;Bezirk Waldenburg;10;VR Waldenburgertal plus;8;VR Waldenburgertal plus;517;4;1;3;19;28;-9;0;-6;511
2011;2888;Langenbruck;1305;Bezirk Waldenburg;10;VR Waldenburgertal plus;8;VR Waldenburgertal plus;994;11;9;2;144;177;-33;0;-31;963
2011;2889;Lauwil;1305;Bezirk Waldenburg;10;VR Waldenburgertal plus;8;VR Waldenburgertal plus;334;7;5;2;12;15;-3;0;-1;333
2011;2890;Liedertswil;1305;Bezirk Waldenburg;10;VR Waldenburgertal plus;8;VR Waldenburgertal plus;160;1;1;0;9;7;2;0;2;162
2011;2891;Niederdorf;1305;Bezirk Waldenburg;10;VR Waldenburgertal plus;8;VR Waldenburgertal plus;1792;16;17;-1;122;148;-26;0;-27;1765
2011;2892;Oberdorf (BL);1305;Bezirk Waldenburg;10;VR Waldenburgertal plus;8;VR Waldenburgertal plus;2284;18;14;4;188;135;53;0;57;2341
2011;2893;Reigoldswil;1305;Bezirk Waldenburg;10;VR Waldenburgertal plus;8;VR Waldenburgertal plus;1566;9;13;-4;116;120;-4;0;-8;1558
2011;2894;Titterten;1305;Bezirk Waldenburg;10;VR Waldenburgertal plus;8;VR Waldenburgertal plus;416;1;3;-2;22;25;-3;0;-5;411
2011;2895;Waldenburg;1305;Bezirk Waldenburg;10;VR Waldenburgertal plus;8;VR Waldenburgertal plus;1221;15;6;9;109;123;-14;0;-5;1216
2012;2761;Aesch (BL);1301;Bezirk Arlesheim;3;VR Alter Birsstadt;3;VR Alter Birsstadt;10312;82;73;9;743;791;-48;-1;-40;10272
2012;2762;Allschwil;1301;Bezirk Arlesheim;1;VR Alter und Gesundheit ABS;1;VR Alter und Gesundheit ABS;19917;212;200;12;1496;1454;42;-1;53;19970
2012;2763;Arlesheim;1301;Bezirk Arlesheim;3;VR Alter Birsstadt;3;VR Alter Birsstadt;9054;72;82;-10;746;693;53;-1;42;9096
2012;2764;Biel-Benken;1301;Bezirk Arlesheim;4;VR BPA Leimental;4;VR BPA Leimental;3155;15;14;1;226;178;48;0;49;3204
2012;2765;Binningen;1301;Bezirk Arlesheim;1;VR Alter und Gesundheit ABS;1;VR Alter und Gesundheit ABS;14843;172;132;40;1190;1158;32;-1;71;14914
2012;2766;Birsfelden;1301;Bezirk Arlesheim;2;VR APG Rheintal;2;VR APG Rheintal;10392;109;108;1;722;778;-56;1;-54;10338
2012;2767;Bottmingen;1301;Bezirk Arlesheim;4;VR BPA Leimental;4;VR BPA Leimental;6156;44;54;-10;681;591;90;0;80;6236
2012;2768;Ettingen;1301;Bezirk Arlesheim;4;VR BPA Leimental;4;VR BPA Leimental;4900;34;31;3;408;413;-5;0;-2;4898
2012;2769;Münchenstein;1301;Bezirk Arlesheim;3;VR Alter Birsstadt;3;VR Alter Birsstadt;11815;112;132;-20;886;862;24;0;4;11819
2012;2770;Muttenz;1301;Bezirk Arlesheim;2;VR APG Rheintal;2;VR APG Rheintal;17392;145;181;-36;1081;1022;59;0;23;17415
2012;2771;Oberwil (BL);1301;Bezirk Arlesheim;4;VR BPA Leimental;4;VR BPA Leimental;10636;99;71;28;872;741;131;-1;158;10794
2012;2772;Pfeffingen;1301;Bezirk Arlesheim;3;VR Alter Birsstadt;3;VR Alter Birsstadt;2197;19;12;7;176;149;27;0;34;2231
2012;2773;Reinach (BL);1301;Bezirk Arlesheim;3;VR Alter Birsstadt;3;VR Alter Birsstadt;18752;145;189;-44;1295;1282;13;0;-31;18721
2012;2774;Schönenbuch;1301;Bezirk Arlesheim;1;VR Alter und Gesundheit ABS;1;VR Alter und Gesundheit ABS;1447;15;10;5;80;114;-34;0;-29;1418
2012;2775;Therwil;1301;Bezirk Arlesheim;4;VR BPA Leimental;4;VR BPA Leimental;9805;71;66;5;644;624;20;0;25;9830
2012;2781;Blauen;1302;Bezirk Laufen;5;VR APG Laufental;5;VR APG Laufental;692;3;7;-4;31;43;-12;0;-16;676
2012;2782;Brislach;1302;Bezirk Laufen;5;VR APG Laufental;5;VR APG Laufental;1611;9;12;-3;119;111;8;1;6;1617
2012;2783;Burg im Leimental;1302;Bezirk Laufen;4;VR BPA Leimental;4;VR BPA Leimental;262;5;3;2;16;23;-7;0;-5;257
2012;2784;Dittingen;1302;Bezirk Laufen;5;VR APG Laufental;5;VR APG Laufental;738;10;5;5;73;60;13;0;18;756
2012;2785;Duggingen;1302;Bezirk Laufen;3;VR Alter Birsstadt;3;VR Alter Birsstadt;1478;12;9;3;139;177;-38;0;-35;1443
2012;2786;Grellingen;1302;Bezirk Laufen;5;VR APG Laufental;5;VR APG Laufental;1760;13;13;0;157;136;21;0;21;1781
2012;2787;Laufen;1302;Bezirk Laufen;5;VR APG Laufental;5;VR APG Laufental;5306;33;50;-17;446;384;62;0;45;5351
2012;2788;Liesberg;1302;Bezirk Laufen;5;VR APG Laufental;5;VR APG Laufental;1188;5;11;-6;65;71;-6;0;-12;1176
2012;2789;Nenzlingen;1302;Bezirk Laufen;5;VR APG Laufental;5;VR APG Laufental;449;1;7;-6;8;24;-16;0;-22;427
2012;2790;Roggenburg;1302;Bezirk Laufen;5;VR APG Laufental;5;VR APG Laufental;281;0;4;-4;32;24;8;0;4;285
2012;2791;Röschenz;1302;Bezirk Laufen;5;VR APG Laufental;5;VR APG Laufental;1837;13;13;0;119;109;10;0;10;1847
2012;2792;Wahlen;1302;Bezirk Laufen;5;VR APG Laufental;5;VR APG Laufental;1326;16;9;7;101;82;19;0;26;1352
2012;2793;Zwingen;1302;Bezirk Laufen;5;VR APG Laufental;5;VR APG Laufental;2171;19;14;5;200;182;18;0;23;2194
2012;2821;Arisdorf;1303;Bezirk Liestal;6;VR Alters- und Pflegeregion Liestal;6;VR Alters- und Pflegeregion Liestal;1602;17;8;9;129;119;10;0;19;1621
2012;2822;Augst;1303;Bezirk Liestal;2;VR APG Rheintal;2;VR APG Rheintal;850;5;11;-6;114;114;0;0;-6;844
2012;2823;Bubendorf;1303;Bezirk Liestal;6;VR Alters- und Pflegeregion Liestal;6;VR Alters- und Pflegeregion Liestal;4419;30;29;1;262;275;-13;0;-12;4407
2012;2824;Frenkendorf;1303;Bezirk Liestal;6;VR Alters- und Pflegeregion Liestal;6;VR Alters- und Pflegeregion Liestal;6242;64;44;20;548;473;75;0;95;6337
2012;2825;Füllinsdorf;1303;Bezirk Liestal;6;VR Alters- und Pflegeregion Liestal;6;VR Alters- und Pflegeregion Liestal;4352;34;46;-12;345;351;-6;0;-18;4334
2012;2826;Giebenach;1303;Bezirk Liestal;2;VR APG Rheintal;2;VR APG Rheintal;971;7;6;1;126;66;60;0;61;1032
2012;2827;Hersberg;1303;Bezirk Liestal;6;VR Alters- und Pflegeregion Liestal;6;VR Alters- und Pflegeregion Liestal;321;2;1;1;23;27;-4;0;-3;318
2012;2828;Lausen;1303;Bezirk Liestal;6;VR Alters- und Pflegeregion Liestal;6;VR Alters- und Pflegeregion Liestal;4858;50;33;17;372;357;15;0;32;4890
2012;2829;Liestal;1303;Bezirk Liestal;6;VR Alters- und Pflegeregion Liestal;6;VR Alters- und Pflegeregion Liestal;13672;143;106;37;1200;1138;62;0;99;13771
2012;2830;Lupsingen;1303;Bezirk Liestal;6;VR Alters- und Pflegeregion Liestal;6;VR Alters- und Pflegeregion Liestal;1360;9;7;2;62;63;-1;0;1;1361
2012;2831;Pratteln;1303;Bezirk Liestal;2;VR APG Rheintal;2;VR APG Rheintal;15305;165;140;25;1064;1017;47;0;72;15377
2012;2832;Ramlinsburg;1303;Bezirk Liestal;10;VR Waldenburgertal plus;8;VR Waldenburgertal plus;689;3;1;2;33;50;-17;0;-15;674
2012;2833;Seltisberg;1303;Bezirk Liestal;6;VR Alters- und Pflegeregion Liestal;6;VR Alters- und Pflegeregion Liestal;1264;13;15;-2;107;79;28;0;26;1290
2012;2834;Ziefen;1303;Bezirk Liestal;6;VR Alters- und Pflegeregion Liestal;6;VR Alters- und Pflegeregion Liestal;1577;16;10;6;100;106;-6;0;0;1577
2012;2841;Anwil;1304;Bezirk Sissach;9;VR Farnsberg plus;7;Planungsregion Oberbaselbiet;580;4;4;0;32;31;1;0;1;581
2012;2842;Böckten;1304;Bezirk Sissach;7;VR Oberbaselbiet;7;Planungsregion Oberbaselbiet;795;9;7;2;61;78;-17;0;-15;780
2012;2843;Buckten;1304;Bezirk Sissach;8;VR Oberes Homburgertal;7;Planungsregion Oberbaselbiet;688;5;2;3;51;52;-1;0;2;690
2012;2844;Buus;1304;Bezirk Sissach;9;VR Farnsberg plus;7;Planungsregion Oberbaselbiet;952;7;5;2;69;61;8;0;10;962
2012;2845;Diepflingen;1304;Bezirk Sissach;7;VR Oberbaselbiet;7;Planungsregion Oberbaselbiet;587;7;7;0;92;29;63;0;63;650
2012;2846;Gelterkinden;1304;Bezirk Sissach;7;VR Oberbaselbiet;7;Planungsregion Oberbaselbiet;5785;41;49;-8;330;356;-26;0;-34;5751
2012;2847;Häfelfingen;1304;Bezirk Sissach;8;VR Oberes Homburgertal;7;Planungsregion Oberbaselbiet;264;2;3;-1;27;10;17;0;16;280
2012;2848;Hemmiken;1304;Bezirk Sissach;9;VR Farnsberg plus;7;Planungsregion Oberbaselbiet;274;2;1;1;16;18;-2;0;-1;273
2012;2849;Itingen;1304;Bezirk Sissach;7;VR Oberbaselbiet;7;Planungsregion Oberbaselbiet;1992;19;7;12;188;168;20;0;32;2024
2012;2850;Känerkinden;1304;Bezirk Sissach;8;VR Oberes Homburgertal;7;Planungsregion Oberbaselbiet;497;5;9;-4;33;44;-11;0;-15;482
2012;2851;Kilchberg (BL);1304;Bezirk Sissach;9;VR Farnsberg plus;7;Planungsregion Oberbaselbiet;151;3;1;2;9;6;3;0;5;156
2012;2852;Läufelfingen;1304;Bezirk Sissach;8;VR Oberes Homburgertal;7;Planungsregion Oberbaselbiet;1273;11;9;2;85;60;25;0;27;1300
2012;2853;Maisprach;1304;Bezirk Sissach;9;VR Farnsberg plus;7;Planungsregion Oberbaselbiet;953;8;4;4;73;84;-11;0;-7;946
2012;2854;Nusshof;1304;Bezirk Sissach;7;VR Oberbaselbiet;7;Planungsregion Oberbaselbiet;234;5;1;4;22;10;12;0;16;250
2012;2855;Oltingen;1304;Bezirk Sissach;9;VR Farnsberg plus;7;Planungsregion Oberbaselbiet;466;7;0;7;29;20;9;0;16;482
2012;2856;Ormalingen;1304;Bezirk Sissach;7;VR Oberbaselbiet;7;Planungsregion Oberbaselbiet;1961;28;16;12;179;160;19;0;31;1992
2012;2857;Rickenbach (BL);1304;Bezirk Sissach;9;VR Farnsberg plus;7;Planungsregion Oberbaselbiet;570;8;2;6;36;34;2;0;8;578
2012;2858;Rothenfluh;1304;Bezirk Sissach;9;VR Farnsberg plus;7;Planungsregion Oberbaselbiet;760;7;6;1;88;66;22;0;23;783
2012;2859;Rümlingen;1304;Bezirk Sissach;8;VR Oberes Homburgertal;7;Planungsregion Oberbaselbiet;373;6;7;-1;39;38;1;0;0;373
2012;2860;Rünenberg;1304;Bezirk Sissach;9;VR Farnsberg plus;7;Planungsregion Oberbaselbiet;767;6;8;-2;43;39;4;0;2;769
2012;2861;Sissach;1304;Bezirk Sissach;7;VR Oberbaselbiet;7;Planungsregion Oberbaselbiet;6271;79;40;39;547;561;-14;0;25;6296
2012;2862;Tecknau;1304;Bezirk Sissach;7;VR Oberbaselbiet;7;Planungsregion Oberbaselbiet;834;12;4;8;75;53;22;1;31;865
2012;2863;Tenniken;1304;Bezirk Sissach;7;VR Oberbaselbiet;7;Planungsregion Oberbaselbiet;878;8;3;5;73;88;-15;0;-10;868
2012;2864;Thürnen;1304;Bezirk Sissach;7;VR Oberbaselbiet;7;Planungsregion Oberbaselbiet;1393;17;13;4;81;124;-43;0;-39;1354
2012;2865;Wenslingen;1304;Bezirk Sissach;7;VR Oberbaselbiet;7;Planungsregion Oberbaselbiet;711;2;6;-4;22;26;-4;0;-8;703
2012;2866;Wintersingen;1304;Bezirk Sissach;9;VR Farnsberg plus;7;Planungsregion Oberbaselbiet;641;5;7;-2;26;49;-23;0;-25;616
2012;2867;Wittinsburg;1304;Bezirk Sissach;7;VR Oberbaselbiet;7;Planungsregion Oberbaselbiet;416;4;2;2;18;23;-5;0;-3;413
2012;2868;Zeglingen;1304;Bezirk Sissach;9;VR Farnsberg plus;7;Planungsregion Oberbaselbiet;456;3;4;-1;44;42;2;0;1;457
2012;2869;Zunzgen;1304;Bezirk Sissach;7;VR Oberbaselbiet;7;Planungsregion Oberbaselbiet;2499;19;15;4;182;183;-1;0;3;2502
2012;2881;Arboldswil;1305;Bezirk Waldenburg;10;VR Waldenburgertal plus;8;VR Waldenburgertal plus;534;6;4;2;23;29;-6;0;-4;530
2012;2882;Bennwil;1305;Bezirk Waldenburg;10;VR Waldenburgertal plus;8;VR Waldenburgertal plus;637;9;2;7;46;43;3;0;10;647
2012;2883;Bretzwil;1305;Bezirk Waldenburg;10;VR Waldenburgertal plus;8;VR Waldenburgertal plus;780;9;11;-2;40;52;-12;0;-14;766
2012;2884;Diegten;1305;Bezirk Waldenburg;7;VR Oberbaselbiet;7;Planungsregion Oberbaselbiet;1556;12;7;5;114;113;1;0;6;1562
2012;2885;Eptingen;1305;Bezirk Waldenburg;7;VR Oberbaselbiet;7;Planungsregion Oberbaselbiet;526;3;6;-3;41;44;-3;0;-6;520
2012;2886;Hölstein;1305;Bezirk Waldenburg;10;VR Waldenburgertal plus;8;VR Waldenburgertal plus;2374;27;14;13;157;169;-12;0;1;2375
2012;2887;Lampenberg;1305;Bezirk Waldenburg;10;VR Waldenburgertal plus;8;VR Waldenburgertal plus;511;1;1;0;21;15;6;0;6;517
2012;2888;Langenbruck;1305;Bezirk Waldenburg;10;VR Waldenburgertal plus;8;VR Waldenburgertal plus;963;10;8;2;134;117;17;0;19;982
2012;2889;Lauwil;1305;Bezirk Waldenburg;10;VR Waldenburgertal plus;8;VR Waldenburgertal plus;333;0;3;-3;25;35;-10;1;-12;321
2012;2890;Liedertswil;1305;Bezirk Waldenburg;10;VR Waldenburgertal plus;8;VR Waldenburgertal plus;162;1;1;0;17;12;5;0;5;167
2012;2891;Niederdorf;1305;Bezirk Waldenburg;10;VR Waldenburgertal plus;8;VR Waldenburgertal plus;1765;10;11;-1;113;125;-12;0;-13;1752
2012;2892;Oberdorf (BL);1305;Bezirk Waldenburg;10;VR Waldenburgertal plus;8;VR Waldenburgertal plus;2341;20;21;-1;176;169;7;0;6;2347
2012;2893;Reigoldswil;1305;Bezirk Waldenburg;10;VR Waldenburgertal plus;8;VR Waldenburgertal plus;1558;12;13;-1;113;123;-10;0;-11;1547
2012;2894;Titterten;1305;Bezirk Waldenburg;10;VR Waldenburgertal plus;8;VR Waldenburgertal plus;411;3;3;0;23;17;6;0;6;417
2012;2895;Waldenburg;1305;Bezirk Waldenburg;10;VR Waldenburgertal plus;8;VR Waldenburgertal plus;1216;11;13;-2;119;137;-18;0;-20;1196
2013;2761;Aesch (BL);1301;Bezirk Arlesheim;3;VR Alter Birsstadt;3;VR Alter Birsstadt;10272;89;86;3;770;776;-6;1;-2;10270
2013;2762;Allschwil;1301;Bezirk Arlesheim;1;VR Alter und Gesundheit ABS;1;VR Alter und Gesundheit ABS;19970;214;186;28;1618;1266;352;0;380;20350
2013;2763;Arlesheim;1301;Bezirk Arlesheim;3;VR Alter Birsstadt;3;VR Alter Birsstadt;9096;73;94;-21;625;537;88;0;67;9163
2013;2764;Biel-Benken;1301;Bezirk Arlesheim;4;VR BPA Leimental;4;VR BPA Leimental;3204;26;25;1;243;173;70;0;71;3275
2013;2765;Binningen;1301;Bezirk Arlesheim;1;VR Alter und Gesundheit ABS;1;VR Alter und Gesundheit ABS;14914;154;157;-3;1144;1084;60;0;57;14971
2013;2766;Birsfelden;1301;Bezirk Arlesheim;2;VR APG Rheintal;2;VR APG Rheintal;10338;84;124;-40;659;673;-14;1;-53;10285
2013;2767;Bottmingen;1301;Bezirk Arlesheim;4;VR BPA Leimental;4;VR BPA Leimental;6236;53;60;-7;673;531;142;0;135;6371
2013;2768;Ettingen;1301;Bezirk Arlesheim;4;VR BPA Leimental;4;VR BPA Leimental;4898;39;50;-11;390;382;8;0;-3;4895
2013;2769;Münchenstein;1301;Bezirk Arlesheim;3;VR Alter Birsstadt;3;VR Alter Birsstadt;11819;100;101;-1;807;887;-80;0;-81;11738
2013;2770;Muttenz;1301;Bezirk Arlesheim;2;VR APG Rheintal;2;VR APG Rheintal;17415;130;168;-38;1082;1010;72;-1;33;17448
2013;2771;Oberwil (BL);1301;Bezirk Arlesheim;4;VR BPA Leimental;4;VR BPA Leimental;10794;90;92;-2;867;849;18;0;16;10810
2013;2772;Pfeffingen;1301;Bezirk Arlesheim;3;VR Alter Birsstadt;3;VR Alter Birsstadt;2231;15;14;1;205;154;51;0;52;2283
2013;2773;Reinach (BL);1301;Bezirk Arlesheim;3;VR Alter Birsstadt;3;VR Alter Birsstadt;18721;122;169;-47;1364;1123;241;0;194;18915
2013;2774;Schönenbuch;1301;Bezirk Arlesheim;1;VR Alter und Gesundheit ABS;1;VR Alter und Gesundheit ABS;1418;8;8;0;96;97;-1;0;-1;1417
2013;2775;Therwil;1301;Bezirk Arlesheim;4;VR BPA Leimental;4;VR BPA Leimental;9830;84;83;1;675;610;65;0;66;9896
2013;2781;Blauen;1302;Bezirk Laufen;5;VR APG Laufental;5;VR APG Laufental;676;6;5;1;54;42;12;0;13;689
2013;2782;Brislach;1302;Bezirk Laufen;5;VR APG Laufental;5;VR APG Laufental;1617;15;8;7;95;96;-1;0;6;1623
2013;2783;Burg im Leimental;1302;Bezirk Laufen;4;VR BPA Leimental;4;VR BPA Leimental;257;3;1;2;16;23;-7;0;-5;252
2013;2784;Dittingen;1302;Bezirk Laufen;5;VR APG Laufental;5;VR APG Laufental;756;10;7;3;69;55;14;0;17;773
2013;2785;Duggingen;1302;Bezirk Laufen;3;VR Alter Birsstadt;3;VR Alter Birsstadt;1443;7;4;3;168;151;17;0;20;1463
2013;2786;Grellingen;1302;Bezirk Laufen;5;VR APG Laufental;5;VR APG Laufental;1781;19;11;8;174;163;11;0;19;1800
2013;2787;Laufen;1302;Bezirk Laufen;5;VR APG Laufental;5;VR APG Laufental;5351;48;44;4;428;372;56;0;60;5411
2013;2788;Liesberg;1302;Bezirk Laufen;5;VR APG Laufental;5;VR APG Laufental;1176;9;12;-3;77;66;11;0;8;1184
2013;2789;Nenzlingen;1302;Bezirk Laufen;5;VR APG Laufental;5;VR APG Laufental;427;0;4;-4;14;15;-1;0;-5;422
2013;2790;Roggenburg;1302;Bezirk Laufen;5;VR APG Laufental;5;VR APG Laufental;285;2;3;-1;24;20;4;0;3;288
2013;2791;Röschenz;1302;Bezirk Laufen;5;VR APG Laufental;5;VR APG Laufental;1847;15;17;-2;119;125;-6;0;-8;1839
2013;2792;Wahlen;1302;Bezirk Laufen;5;VR APG Laufental;5;VR APG Laufental;1352;7;12;-5;126;69;57;0;52;1404
2013;2793;Zwingen;1302;Bezirk Laufen;5;VR APG Laufental;5;VR APG Laufental;2194;27;6;21;213;215;-2;0;19;2213
2013;2821;Arisdorf;1303;Bezirk Liestal;6;VR Alters- und Pflegeregion Liestal;6;VR Alters- und Pflegeregion Liestal;1621;9;17;-8;108;102;6;0;-2;1619
2013;2822;Augst;1303;Bezirk Liestal;2;VR APG Rheintal;2;VR APG Rheintal;844;5;9;-4;139;105;34;0;30;874
2013;2823;Bubendorf;1303;Bezirk Liestal;6;VR Alters- und Pflegeregion Liestal;6;VR Alters- und Pflegeregion Liestal;4407;34;28;6;299;270;29;0;35;4442
2013;2824;Frenkendorf;1303;Bezirk Liestal;6;VR Alters- und Pflegeregion Liestal;6;VR Alters- und Pflegeregion Liestal;6337;58;45;13;468;398;70;0;83;6420
2013;2825;Füllinsdorf;1303;Bezirk Liestal;6;VR Alters- und Pflegeregion Liestal;6;VR Alters- und Pflegeregion Liestal;4334;29;50;-21;377;337;40;0;19;4353
2013;2826;Giebenach;1303;Bezirk Liestal;2;VR APG Rheintal;2;VR APG Rheintal;1032;17;7;10;105;75;30;0;40;1072
2013;2827;Hersberg;1303;Bezirk Liestal;6;VR Alters- und Pflegeregion Liestal;6;VR Alters- und Pflegeregion Liestal;318;3;1;2;31;21;10;0;12;330
2013;2828;Lausen;1303;Bezirk Liestal;6;VR Alters- und Pflegeregion Liestal;6;VR Alters- und Pflegeregion Liestal;4890;41;30;11;411;298;113;0;124;5014
2013;2829;Liestal;1303;Bezirk Liestal;6;VR Alters- und Pflegeregion Liestal;6;VR Alters- und Pflegeregion Liestal;13771;134;112;22;1180;1101;79;0;101;13872
2013;2830;Lupsingen;1303;Bezirk Liestal;6;VR Alters- und Pflegeregion Liestal;6;VR Alters- und Pflegeregion Liestal;1361;9;12;-3;74;61;13;0;10;1371
2013;2831;Pratteln;1303;Bezirk Liestal;2;VR APG Rheintal;2;VR APG Rheintal;15377;156;134;22;1008;1021;-13;0;9;15386
2013;2832;Ramlinsburg;1303;Bezirk Liestal;10;VR Waldenburgertal plus;8;VR Waldenburgertal plus;674;2;5;-3;59;38;21;0;18;692
2013;2833;Seltisberg;1303;Bezirk Liestal;6;VR Alters- und Pflegeregion Liestal;6;VR Alters- und Pflegeregion Liestal;1290;7;10;-3;65;59;6;0;3;1293
2013;2834;Ziefen;1303;Bezirk Liestal;6;VR Alters- und Pflegeregion Liestal;6;VR Alters- und Pflegeregion Liestal;1577;18;20;-2;86;82;4;0;2;1579
2013;2841;Anwil;1304;Bezirk Sissach;9;VR Farnsberg plus;7;Planungsregion Oberbaselbiet;581;2;3;-1;27;18;9;0;8;589
2013;2842;Böckten;1304;Bezirk Sissach;7;VR Oberbaselbiet;7;Planungsregion Oberbaselbiet;780;4;8;-4;89;70;19;0;15;795
2013;2843;Buckten;1304;Bezirk Sissach;8;VR Oberes Homburgertal;7;Planungsregion Oberbaselbiet;690;6;9;-3;79;66;13;0;10;700
2013;2844;Buus;1304;Bezirk Sissach;9;VR Farnsberg plus;7;Planungsregion Oberbaselbiet;962;9;13;-4;63;47;16;0;12;974
2013;2845;Diepflingen;1304;Bezirk Sissach;7;VR Oberbaselbiet;7;Planungsregion Oberbaselbiet;650;11;7;4;82;42;40;0;44;694
2013;2846;Gelterkinden;1304;Bezirk Sissach;7;VR Oberbaselbiet;7;Planungsregion Oberbaselbiet;5751;44;41;3;425;405;20;0;23;5774
2013;2847;Häfelfingen;1304;Bezirk Sissach;8;VR Oberes Homburgertal;7;Planungsregion Oberbaselbiet;280;3;3;0;13;20;-7;0;-7;273
2013;2848;Hemmiken;1304;Bezirk Sissach;9;VR Farnsberg plus;7;Planungsregion Oberbaselbiet;273;2;4;-2;10;18;-8;0;-10;263
2013;2849;Itingen;1304;Bezirk Sissach;7;VR Oberbaselbiet;7;Planungsregion Oberbaselbiet;2024;16;16;0;172;139;33;0;33;2057
2013;2850;Känerkinden;1304;Bezirk Sissach;8;VR Oberes Homburgertal;7;Planungsregion Oberbaselbiet;482;3;5;-2;44;35;9;0;7;489
2013;2851;Kilchberg (BL);1304;Bezirk Sissach;9;VR Farnsberg plus;7;Planungsregion Oberbaselbiet;156;2;1;1;6;7;-1;0;0;156
2013;2852;Läufelfingen;1304;Bezirk Sissach;8;VR Oberes Homburgertal;7;Planungsregion Oberbaselbiet;1300;12;16;-4;52;77;-25;0;-29;1271
2013;2853;Maisprach;1304;Bezirk Sissach;9;VR Farnsberg plus;7;Planungsregion Oberbaselbiet;946;7;7;0;83;78;5;0;5;951
2013;2854;Nusshof;1304;Bezirk Sissach;7;VR Oberbaselbiet;7;Planungsregion Oberbaselbiet;250;2;0;2;11;13;-2;0;0;250
2013;2855;Oltingen;1304;Bezirk Sissach;9;VR Farnsberg plus;7;Planungsregion Oberbaselbiet;482;4;4;0;19;25;-6;0;-6;476
2013;2856;Ormalingen;1304;Bezirk Sissach;7;VR Oberbaselbiet;7;Planungsregion Oberbaselbiet;1992;13;12;1;180;164;16;0;17;2009
2013;2857;Rickenbach (BL);1304;Bezirk Sissach;9;VR Farnsberg plus;7;Planungsregion Oberbaselbiet;578;5;2;3;45;37;8;0;11;589
2013;2858;Rothenfluh;1304;Bezirk Sissach;9;VR Farnsberg plus;7;Planungsregion Oberbaselbiet;783;10;3;7;56;66;-10;0;-3;780
2013;2859;Rümlingen;1304;Bezirk Sissach;8;VR Oberes Homburgertal;7;Planungsregion Oberbaselbiet;373;7;2;5;42;22;20;0;25;398
2013;2860;Rünenberg;1304;Bezirk Sissach;9;VR Farnsberg plus;7;Planungsregion Oberbaselbiet;769;4;8;-4;39;37;2;0;-2;767
2013;2861;Sissach;1304;Bezirk Sissach;7;VR Oberbaselbiet;7;Planungsregion Oberbaselbiet;6296;82;46;36;611;509;102;0;138;6434
2013;2862;Tecknau;1304;Bezirk Sissach;7;VR Oberbaselbiet;7;Planungsregion Oberbaselbiet;865;7;5;2;79;83;-4;0;-2;863
2013;2863;Tenniken;1304;Bezirk Sissach;7;VR Oberbaselbiet;7;Planungsregion Oberbaselbiet;868;4;6;-2;85;62;23;0;21;889
2013;2864;Thürnen;1304;Bezirk Sissach;7;VR Oberbaselbiet;7;Planungsregion Oberbaselbiet;1354;18;7;11;128;141;-13;0;-2;1352
2013;2865;Wenslingen;1304;Bezirk Sissach;7;VR Oberbaselbiet;7;Planungsregion Oberbaselbiet;703;7;6;1;41;19;22;0;23;726
2013;2866;Wintersingen;1304;Bezirk Sissach;9;VR Farnsberg plus;7;Planungsregion Oberbaselbiet;616;9;3;6;43;45;-2;0;4;620
2013;2867;Wittinsburg;1304;Bezirk Sissach;7;VR Oberbaselbiet;7;Planungsregion Oberbaselbiet;413;1;0;1;37;27;10;0;11;424
2013;2868;Zeglingen;1304;Bezirk Sissach;9;VR Farnsberg plus;7;Planungsregion Oberbaselbiet;457;5;6;-1;46;33;13;0;12;469
2013;2869;Zunzgen;1304;Bezirk Sissach;7;VR Oberbaselbiet;7;Planungsregion Oberbaselbiet;2502;14;18;-4;183;173;10;0;6;2508
2013;2881;Arboldswil;1305;Bezirk Waldenburg;10;VR Waldenburgertal plus;8;VR Waldenburgertal plus;530;3;0;3;25;13;12;0;15;545
2013;2882;Bennwil;1305;Bezirk Waldenburg;10;VR Waldenburgertal plus;8;VR Waldenburgertal plus;647;5;3;2;49;53;-4;0;-2;645
2013;2883;Bretzwil;1305;Bezirk Waldenburg;10;VR Waldenburgertal plus;8;VR Waldenburgertal plus;766;4;4;0;50;54;-4;0;-4;762
2013;2884;Diegten;1305;Bezirk Waldenburg;7;VR Oberbaselbiet;7;Planungsregion Oberbaselbiet;1562;12;16;-4;161;102;59;0;55;1617
2013;2885;Eptingen;1305;Bezirk Waldenburg;7;VR Oberbaselbiet;7;Planungsregion Oberbaselbiet;520;8;5;3;47;47;0;0;3;523
2013;2886;Hölstein;1305;Bezirk Waldenburg;10;VR Waldenburgertal plus;8;VR Waldenburgertal plus;2375;26;14;12;216;227;-11;0;1;2376
2013;2887;Lampenberg;1305;Bezirk Waldenburg;10;VR Waldenburgertal plus;8;VR Waldenburgertal plus;517;4;3;1;15;22;-7;0;-6;511
2013;2888;Langenbruck;1305;Bezirk Waldenburg;10;VR Waldenburgertal plus;8;VR Waldenburgertal plus;982;3;4;-1;142;108;34;0;33;1015
2013;2889;Lauwil;1305;Bezirk Waldenburg;10;VR Waldenburgertal plus;8;VR Waldenburgertal plus;321;3;0;3;26;15;11;0;14;335
2013;2890;Liedertswil;1305;Bezirk Waldenburg;10;VR Waldenburgertal plus;8;VR Waldenburgertal plus;167;2;1;1;8;10;-2;0;-1;166
2013;2891;Niederdorf;1305;Bezirk Waldenburg;10;VR Waldenburgertal plus;8;VR Waldenburgertal plus;1752;11;16;-5;144;145;-1;0;-6;1746
2013;2892;Oberdorf (BL);1305;Bezirk Waldenburg;10;VR Waldenburgertal plus;8;VR Waldenburgertal plus;2347;16;15;1;192;190;2;0;3;2350
2013;2893;Reigoldswil;1305;Bezirk Waldenburg;10;VR Waldenburgertal plus;8;VR Waldenburgertal plus;1547;17;16;1;110;90;20;0;21;1568
2013;2894;Titterten;1305;Bezirk Waldenburg;10;VR Waldenburgertal plus;8;VR Waldenburgertal plus;417;2;5;-3;29;25;4;0;1;418
2013;2895;Waldenburg;1305;Bezirk Waldenburg;10;VR Waldenburgertal plus;8;VR Waldenburgertal plus;1196;10;14;-4;91;95;-4;0;-8;1188
2014;2761;Aesch (BL);1301;Bezirk Arlesheim;3;VR Alter Birsstadt;3;VR Alter Birsstadt;10270;70;85;-15;678;701;-23;0;-38;10232
2014;2762;Allschwil;1301;Bezirk Arlesheim;1;VR Alter und Gesundheit ABS;1;VR Alter und Gesundheit ABS;20350;220;167;53;1381;1304;77;0;130;20480
2014;2763;Arlesheim;1301;Bezirk Arlesheim;3;VR Alter Birsstadt;3;VR Alter Birsstadt;9163;70;101;-31;619;575;44;0;13;9176
2014;2764;Biel-Benken;1301;Bezirk Arlesheim;4;VR BPA Leimental;4;VR BPA Leimental;3275;21;20;1;272;186;86;0;87;3362
2014;2765;Binningen;1301;Bezirk Arlesheim;1;VR Alter und Gesundheit ABS;1;VR Alter und Gesundheit ABS;14971;154;153;1;1307;1096;211;0;212;15183
2014;2766;Birsfelden;1301;Bezirk Arlesheim;2;VR APG Rheintal;2;VR APG Rheintal;10285;98;118;-20;797;696;101;0;81;10366
2014;2767;Bottmingen;1301;Bezirk Arlesheim;4;VR BPA Leimental;4;VR BPA Leimental;6371;62;60;2;577;583;-6;0;-4;6367
2014;2768;Ettingen;1301;Bezirk Arlesheim;4;VR BPA Leimental;4;VR BPA Leimental;4895;38;38;0;374;327;47;0;47;4942
2014;2769;Münchenstein;1301;Bezirk Arlesheim;3;VR Alter Birsstadt;3;VR Alter Birsstadt;11738;85;125;-40;1068;836;232;0;192;11930
2014;2770;Muttenz;1301;Bezirk Arlesheim;2;VR APG Rheintal;2;VR APG Rheintal;17448;156;150;6;1093;953;140;0;146;17594
2014;2771;Oberwil (BL);1301;Bezirk Arlesheim;4;VR BPA Leimental;4;VR BPA Leimental;10810;101;96;5;952;775;177;0;182;10992
2014;2772;Pfeffingen;1301;Bezirk Arlesheim;3;VR Alter Birsstadt;3;VR Alter Birsstadt;2283;13;14;-1;177;112;65;0;64;2347
2014;2773;Reinach (BL);1301;Bezirk Arlesheim;3;VR Alter Birsstadt;3;VR Alter Birsstadt;18915;140;195;-55;1239;1201;38;0;-17;18898
2014;2774;Schönenbuch;1301;Bezirk Arlesheim;1;VR Alter und Gesundheit ABS;1;VR Alter und Gesundheit ABS;1417;15;8;7;104;102;2;0;9;1426
2014;2775;Therwil;1301;Bezirk Arlesheim;4;VR BPA Leimental;4;VR BPA Leimental;9896;88;76;12;713;602;111;0;123;10019
2014;2781;Blauen;1302;Bezirk Laufen;5;VR APG Laufental;5;VR APG Laufental;689;7;7;0;57;34;23;0;23;712
2014;2782;Brislach;1302;Bezirk Laufen;5;VR APG Laufental;5;VR APG Laufental;1623;3;9;-6;83;80;3;0;-3;1620
2014;2783;Burg im Leimental;1302;Bezirk Laufen;4;VR BPA Leimental;4;VR BPA Leimental;252;1;2;-1;19;5;14;0;13;265
2014;2784;Dittingen;1302;Bezirk Laufen;5;VR APG Laufental;5;VR APG Laufental;773;4;12;-8;48;60;-12;0;-20;753
2014;2785;Duggingen;1302;Bezirk Laufen;3;VR Alter Birsstadt;3;VR Alter Birsstadt;1463;17;8;9;185;159;26;0;35;1498
2014;2786;Grellingen;1302;Bezirk Laufen;5;VR APG Laufental;5;VR APG Laufental;1800;15;9;6;207;196;11;0;17;1817
2014;2787;Laufen;1302;Bezirk Laufen;5;VR APG Laufental;5;VR APG Laufental;5411;39;47;-8;463;347;116;0;108;5519
2014;2788;Liesberg;1302;Bezirk Laufen;5;VR APG Laufental;5;VR APG Laufental;1184;8;14;-6;57;61;-4;0;-10;1174
2014;2789;Nenzlingen;1302;Bezirk Laufen;5;VR APG Laufental;5;VR APG Laufental;422;7;2;5;32;33;-1;0;4;426
2014;2790;Roggenburg;1302;Bezirk Laufen;5;VR APG Laufental;5;VR APG Laufental;288;2;0;2;14;13;1;0;3;291
2014;2791;Röschenz;1302;Bezirk Laufen;5;VR APG Laufental;5;VR APG Laufental;1839;13;18;-5;124;115;9;0;4;1843
2014;2792;Wahlen;1302;Bezirk Laufen;5;VR APG Laufental;5;VR APG Laufental;1404;11;10;1;89;83;6;0;7;1411
2014;2793;Zwingen;1302;Bezirk Laufen;5;VR APG Laufental;5;VR APG Laufental;2213;21;16;5;231;196;35;0;40;2253
2014;2821;Arisdorf;1303;Bezirk Liestal;6;VR Alters- und Pflegeregion Liestal;6;VR Alters- und Pflegeregion Liestal;1619;16;15;1;107;108;-1;0;0;1619
2014;2822;Augst;1303;Bezirk Liestal;2;VR APG Rheintal;2;VR APG Rheintal;874;6;9;-3;96;119;-23;0;-26;848
2014;2823;Bubendorf;1303;Bezirk Liestal;6;VR Alters- und Pflegeregion Liestal;6;VR Alters- und Pflegeregion Liestal;4442;33;18;15;260;290;-30;0;-15;4427
2014;2824;Frenkendorf;1303;Bezirk Liestal;6;VR Alters- und Pflegeregion Liestal;6;VR Alters- und Pflegeregion Liestal;6420;64;50;14;497;456;41;0;55;6475
2014;2825;Füllinsdorf;1303;Bezirk Liestal;6;VR Alters- und Pflegeregion Liestal;6;VR Alters- und Pflegeregion Liestal;4353;37;27;10;387;348;39;0;49;4402
2014;2826;Giebenach;1303;Bezirk Liestal;2;VR APG Rheintal;2;VR APG Rheintal;1072;11;7;4;98;109;-11;0;-7;1065
2014;2827;Hersberg;1303;Bezirk Liestal;6;VR Alters- und Pflegeregion Liestal;6;VR Alters- und Pflegeregion Liestal;330;3;4;-1;25;16;9;0;8;338
2014;2828;Lausen;1303;Bezirk Liestal;6;VR Alters- und Pflegeregion Liestal;6;VR Alters- und Pflegeregion Liestal;5014;43;44;-1;433;388;45;0;44;5058
2014;2829;Liestal;1303;Bezirk Liestal;6;VR Alters- und Pflegeregion Liestal;6;VR Alters- und Pflegeregion Liestal;13872;159;103;56;1154;1066;88;0;144;14016
2014;2830;Lupsingen;1303;Bezirk Liestal;6;VR Alters- und Pflegeregion Liestal;6;VR Alters- und Pflegeregion Liestal;1371;9;11;-2;94;62;32;0;30;1401
2014;2831;Pratteln;1303;Bezirk Liestal;2;VR APG Rheintal;2;VR APG Rheintal;15386;176;123;53;1113;887;226;0;279;15665
2014;2832;Ramlinsburg;1303;Bezirk Liestal;10;VR Waldenburgertal plus;8;VR Waldenburgertal plus;692;3;6;-3;51;42;9;0;6;698
2014;2833;Seltisberg;1303;Bezirk Liestal;6;VR Alters- und Pflegeregion Liestal;6;VR Alters- und Pflegeregion Liestal;1293;10;8;2;72;59;13;0;15;1308
2014;2834;Ziefen;1303;Bezirk Liestal;6;VR Alters- und Pflegeregion Liestal;6;VR Alters- und Pflegeregion Liestal;1579;17;14;3;64;91;-27;0;-24;1555
2014;2841;Anwil;1304;Bezirk Sissach;9;VR Farnsberg plus;7;Planungsregion Oberbaselbiet;589;5;1;4;19;33;-14;0;-10;579
2014;2842;Böckten;1304;Bezirk Sissach;7;VR Oberbaselbiet;7;Planungsregion Oberbaselbiet;795;11;3;8;56;44;12;0;20;815
2014;2843;Buckten;1304;Bezirk Sissach;8;VR Oberes Homburgertal;7;Planungsregion Oberbaselbiet;700;7;2;5;37;42;-5;0;0;700
2014;2844;Buus;1304;Bezirk Sissach;9;VR Farnsberg plus;7;Planungsregion Oberbaselbiet;974;12;9;3;58;56;2;0;5;979
2014;2845;Diepflingen;1304;Bezirk Sissach;7;VR Oberbaselbiet;7;Planungsregion Oberbaselbiet;694;4;6;-2;50;53;-3;0;-5;689
2014;2846;Gelterkinden;1304;Bezirk Sissach;7;VR Oberbaselbiet;7;Planungsregion Oberbaselbiet;5774;61;55;6;459;339;120;0;126;5900
2014;2847;Häfelfingen;1304;Bezirk Sissach;8;VR Oberes Homburgertal;7;Planungsregion Oberbaselbiet;273;0;1;-1;19;20;-1;0;-2;271
2014;2848;Hemmiken;1304;Bezirk Sissach;9;VR Farnsberg plus;7;Planungsregion Oberbaselbiet;263;4;2;2;23;28;-5;0;-3;260
2014;2849;Itingen;1304;Bezirk Sissach;7;VR Oberbaselbiet;7;Planungsregion Oberbaselbiet;2057;24;9;15;150;143;7;0;22;2079
2014;2850;Känerkinden;1304;Bezirk Sissach;8;VR Oberes Homburgertal;7;Planungsregion Oberbaselbiet;489;2;4;-2;41;27;14;0;12;501
2014;2851;Kilchberg (BL);1304;Bezirk Sissach;9;VR Farnsberg plus;7;Planungsregion Oberbaselbiet;156;1;1;0;14;13;1;0;1;157
2014;2852;Läufelfingen;1304;Bezirk Sissach;8;VR Oberes Homburgertal;7;Planungsregion Oberbaselbiet;1271;2;22;-20;117;72;45;0;25;1296
2014;2853;Maisprach;1304;Bezirk Sissach;9;VR Farnsberg plus;7;Planungsregion Oberbaselbiet;951;7;8;-1;73;80;-7;0;-8;943
2014;2854;Nusshof;1304;Bezirk Sissach;7;VR Oberbaselbiet;7;Planungsregion Oberbaselbiet;250;1;0;1;23;8;15;0;16;266
2014;2855;Oltingen;1304;Bezirk Sissach;9;VR Farnsberg plus;7;Planungsregion Oberbaselbiet;476;9;7;2;25;24;1;0;3;479
2014;2856;Ormalingen;1304;Bezirk Sissach;7;VR Oberbaselbiet;7;Planungsregion Oberbaselbiet;2009;19;12;7;225;167;58;0;65;2074
2014;2857;Rickenbach (BL);1304;Bezirk Sissach;9;VR Farnsberg plus;7;Planungsregion Oberbaselbiet;589;3;9;-6;30;48;-18;0;-24;565
2014;2858;Rothenfluh;1304;Bezirk Sissach;9;VR Farnsberg plus;7;Planungsregion Oberbaselbiet;780;6;7;-1;71;62;9;0;8;788
2014;2859;Rümlingen;1304;Bezirk Sissach;8;VR Oberes Homburgertal;7;Planungsregion Oberbaselbiet;398;1;2;-1;34;41;-7;0;-8;390
2014;2860;Rünenberg;1304;Bezirk Sissach;9;VR Farnsberg plus;7;Planungsregion Oberbaselbiet;767;8;5;3;44;32;12;0;15;782
2014;2861;Sissach;1304;Bezirk Sissach;7;VR Oberbaselbiet;7;Planungsregion Oberbaselbiet;6434;56;55;1;453;398;55;0;56;6490
2014;2862;Tecknau;1304;Bezirk Sissach;7;VR Oberbaselbiet;7;Planungsregion Oberbaselbiet;863;11;2;9;88;94;-6;0;3;866
2014;2863;Tenniken;1304;Bezirk Sissach;7;VR Oberbaselbiet;7;Planungsregion Oberbaselbiet;889;8;4;4;54;51;3;0;7;896
2014;2864;Thürnen;1304;Bezirk Sissach;7;VR Oberbaselbiet;7;Planungsregion Oberbaselbiet;1352;12;9;3;164;118;46;0;49;1401
2014;2865;Wenslingen;1304;Bezirk Sissach;7;VR Oberbaselbiet;7;Planungsregion Oberbaselbiet;726;6;0;6;35;35;0;0;6;732
2014;2866;Wintersingen;1304;Bezirk Sissach;9;VR Farnsberg plus;7;Planungsregion Oberbaselbiet;620;5;7;-2;50;53;-3;0;-5;615
2014;2867;Wittinsburg;1304;Bezirk Sissach;7;VR Oberbaselbiet;7;Planungsregion Oberbaselbiet;424;1;0;1;24;19;5;0;6;430
2014;2868;Zeglingen;1304;Bezirk Sissach;9;VR Farnsberg plus;7;Planungsregion Oberbaselbiet;469;3;4;-1;38;28;10;0;9;478
2014;2869;Zunzgen;1304;Bezirk Sissach;7;VR Oberbaselbiet;7;Planungsregion Oberbaselbiet;2508;15;17;-2;174;172;2;0;0;2508
2014;2881;Arboldswil;1305;Bezirk Waldenburg;10;VR Waldenburgertal plus;8;VR Waldenburgertal plus;545;3;4;-1;28;18;10;0;9;554
2014;2882;Bennwil;1305;Bezirk Waldenburg;10;VR Waldenburgertal plus;8;VR Waldenburgertal plus;645;10;3;7;33;42;-9;0;-2;643
2014;2883;Bretzwil;1305;Bezirk Waldenburg;10;VR Waldenburgertal plus;8;VR Waldenburgertal plus;762;8;7;1;39;43;-4;0;-3;759
2014;2884;Diegten;1305;Bezirk Waldenburg;7;VR Oberbaselbiet;7;Planungsregion Oberbaselbiet;1617;19;6;13;122;108;14;0;27;1644
2014;2885;Eptingen;1305;Bezirk Waldenburg;7;VR Oberbaselbiet;7;Planungsregion Oberbaselbiet;523;5;3;2;48;36;12;0;14;537
2014;2886;Hölstein;1305;Bezirk Waldenburg;10;VR Waldenburgertal plus;8;VR Waldenburgertal plus;2376;22;16;6;206;204;2;0;8;2384
2014;2887;Lampenberg;1305;Bezirk Waldenburg;10;VR Waldenburgertal plus;8;VR Waldenburgertal plus;511;6;5;1;16;18;-2;0;-1;510
2014;2888;Langenbruck;1305;Bezirk Waldenburg;10;VR Waldenburgertal plus;8;VR Waldenburgertal plus;1015;8;7;1;156;158;-2;0;-1;1014
2014;2889;Lauwil;1305;Bezirk Waldenburg;10;VR Waldenburgertal plus;8;VR Waldenburgertal plus;335;2;2;0;22;22;0;0;0;335
2014;2890;Liedertswil;1305;Bezirk Waldenburg;10;VR Waldenburgertal plus;8;VR Waldenburgertal plus;166;2;1;1;8;11;-3;0;-2;164
2014;2891;Niederdorf;1305;Bezirk Waldenburg;10;VR Waldenburgertal plus;8;VR Waldenburgertal plus;1746;15;17;-2;157;123;34;0;32;1778
2014;2892;Oberdorf (BL);1305;Bezirk Waldenburg;10;VR Waldenburgertal plus;8;VR Waldenburgertal plus;2350;26;15;11;214;170;44;0;55;2405
2014;2893;Reigoldswil;1305;Bezirk Waldenburg;10;VR Waldenburgertal plus;8;VR Waldenburgertal plus;1568;10;16;-6;123;82;41;0;35;1603
2014;2894;Titterten;1305;Bezirk Waldenburg;10;VR Waldenburgertal plus;8;VR Waldenburgertal plus;418;1;4;-3;37;32;5;0;2;420
2014;2895;Waldenburg;1305;Bezirk Waldenburg;10;VR Waldenburgertal plus;8;VR Waldenburgertal plus;1188;14;13;1;122;110;12;0;13;1201
2015;2761;Aesch (BL);1301;Bezirk Arlesheim;3;VR Alter Birsstadt;3;VR Alter Birsstadt;10232;91;72;19;745;739;6;0;25;10257
2015;2762;Allschwil;1301;Bezirk Arlesheim;1;VR Alter und Gesundheit ABS;1;VR Alter und Gesundheit ABS;20480;193;215;-22;1481;1383;98;0;76;20556
2015;2763;Arlesheim;1301;Bezirk Arlesheim;3;VR Alter Birsstadt;3;VR Alter Birsstadt;9176;65;111;-46;727;603;124;0;78;9254
2015;2764;Biel-Benken;1301;Bezirk Arlesheim;4;VR BPA Leimental;4;VR BPA Leimental;3362;22;25;-3;322;247;75;0;72;3434
2015;2765;Binningen;1301;Bezirk Arlesheim;1;VR Alter und Gesundheit ABS;1;VR Alter und Gesundheit ABS;15183;167;147;20;1197;1200;-3;0;17;15200
2015;2766;Birsfelden;1301;Bezirk Arlesheim;2;VR APG Rheintal;2;VR APG Rheintal;10366;104;124;-20;795;714;81;0;61;10427
2015;2767;Bottmingen;1301;Bezirk Arlesheim;4;VR BPA Leimental;4;VR BPA Leimental;6367;72;58;14;707;586;121;0;135;6502
2015;2768;Ettingen;1301;Bezirk Arlesheim;4;VR BPA Leimental;4;VR BPA Leimental;4942;40;32;8;340;286;54;0;62;5004
2015;2769;Münchenstein;1301;Bezirk Arlesheim;3;VR Alter Birsstadt;3;VR Alter Birsstadt;11930;104;147;-43;1020;921;99;0;56;11986
2015;2770;Muttenz;1301;Bezirk Arlesheim;2;VR APG Rheintal;2;VR APG Rheintal;17594;154;186;-32;1188;1021;167;-1;134;17728
2015;2771;Oberwil (BL);1301;Bezirk Arlesheim;4;VR BPA Leimental;4;VR BPA Leimental;10992;106;102;4;900;740;160;0;164;11156
2015;2772;Pfeffingen;1301;Bezirk Arlesheim;3;VR Alter Birsstadt;3;VR Alter Birsstadt;2347;12;16;-4;200;170;30;0;26;2373
2015;2773;Reinach (BL);1301;Bezirk Arlesheim;3;VR Alter Birsstadt;3;VR Alter Birsstadt;18898;138;167;-29;1374;1288;86;0;57;18955
2015;2774;Schönenbuch;1301;Bezirk Arlesheim;1;VR Alter und Gesundheit ABS;1;VR Alter und Gesundheit ABS;1426;13;13;0;73;112;-39;0;-39;1387
2015;2775;Therwil;1301;Bezirk Arlesheim;4;VR BPA Leimental;4;VR BPA Leimental;10019;75;78;-3;726;657;69;0;66;10085
2015;2781;Blauen;1302;Bezirk Laufen;5;VR APG Laufental;5;VR APG Laufental;712;4;6;-2;25;37;-12;0;-14;698
2015;2782;Brislach;1302;Bezirk Laufen;5;VR APG Laufental;5;VR APG Laufental;1620;11;16;-5;97;93;4;0;-1;1619
2015;2783;Burg im Leimental;1302;Bezirk Laufen;4;VR BPA Leimental;4;VR BPA Leimental;265;2;1;1;14;17;-3;0;-2;263
2015;2784;Dittingen;1302;Bezirk Laufen;5;VR APG Laufental;5;VR APG Laufental;753;5;9;-4;68;76;-8;0;-12;741
2015;2785;Duggingen;1302;Bezirk Laufen;3;VR Alter Birsstadt;3;VR Alter Birsstadt;1498;13;12;1;197;168;29;0;30;1528
2015;2786;Grellingen;1302;Bezirk Laufen;5;VR APG Laufental;5;VR APG Laufental;1817;26;21;5;208;177;31;0;36;1853
2015;2787;Laufen;1302;Bezirk Laufen;5;VR APG Laufental;5;VR APG Laufental;5519;57;50;7;462;422;40;0;47;5566
2015;2788;Liesberg;1302;Bezirk Laufen;5;VR APG Laufental;5;VR APG Laufental;1174;8;12;-4;61;55;6;-1;1;1175
2015;2789;Nenzlingen;1302;Bezirk Laufen;5;VR APG Laufental;5;VR APG Laufental;426;2;2;0;31;33;-2;0;-2;424
2015;2790;Roggenburg;1302;Bezirk Laufen;5;VR APG Laufental;5;VR APG Laufental;291;0;4;-4;13;20;-7;0;-11;280
2015;2791;Röschenz;1302;Bezirk Laufen;5;VR APG Laufental;5;VR APG Laufental;1843;14;19;-5;103;89;14;0;9;1852
2015;2792;Wahlen;1302;Bezirk Laufen;5;VR APG Laufental;5;VR APG Laufental;1411;12;11;1;104;100;4;0;5;1416
2015;2793;Zwingen;1302;Bezirk Laufen;5;VR APG Laufental;5;VR APG Laufental;2253;28;16;12;250;235;15;0;27;2280
2015;2821;Arisdorf;1303;Bezirk Liestal;6;VR Alters- und Pflegeregion Liestal;6;VR Alters- und Pflegeregion Liestal;1619;12;11;1;139;95;44;0;45;1664
2015;2822;Augst;1303;Bezirk Liestal;2;VR APG Rheintal;2;VR APG Rheintal;848;6;10;-4;203;92;111;0;107;955
2015;2823;Bubendorf;1303;Bezirk Liestal;6;VR Alters- und Pflegeregion Liestal;6;VR Alters- und Pflegeregion Liestal;4427;25;39;-14;312;315;-3;0;-17;4410
2015;2824;Frenkendorf;1303;Bezirk Liestal;6;VR Alters- und Pflegeregion Liestal;6;VR Alters- und Pflegeregion Liestal;6475;64;49;15;506;473;33;0;48;6523
2015;2825;Füllinsdorf;1303;Bezirk Liestal;6;VR Alters- und Pflegeregion Liestal;6;VR Alters- und Pflegeregion Liestal;4402;54;44;10;346;341;5;0;15;4417
2015;2826;Giebenach;1303;Bezirk Liestal;2;VR APG Rheintal;2;VR APG Rheintal;1065;8;5;3;96;118;-22;0;-19;1046
2015;2827;Hersberg;1303;Bezirk Liestal;6;VR Alters- und Pflegeregion Liestal;6;VR Alters- und Pflegeregion Liestal;338;2;3;-1;10;20;-10;0;-11;327
2015;2828;Lausen;1303;Bezirk Liestal;6;VR Alters- und Pflegeregion Liestal;6;VR Alters- und Pflegeregion Liestal;5058;54;48;6;341;370;-29;0;-23;5035
2015;2829;Liestal;1303;Bezirk Liestal;6;VR Alters- und Pflegeregion Liestal;6;VR Alters- und Pflegeregion Liestal;14016;157;110;47;1096;1025;71;0;118;14134
2015;2830;Lupsingen;1303;Bezirk Liestal;6;VR Alters- und Pflegeregion Liestal;6;VR Alters- und Pflegeregion Liestal;1401;12;12;0;114;84;30;0;30;1431
2015;2831;Pratteln;1303;Bezirk Liestal;2;VR APG Rheintal;2;VR APG Rheintal;15665;168;133;35;1236;945;291;0;326;15991
2015;2832;Ramlinsburg;1303;Bezirk Liestal;10;VR Waldenburgertal plus;8;VR Waldenburgertal plus;698;2;6;-4;52;48;4;0;0;698
2015;2833;Seltisberg;1303;Bezirk Liestal;6;VR Alters- und Pflegeregion Liestal;6;VR Alters- und Pflegeregion Liestal;1308;8;15;-7;84;68;16;0;9;1317
2015;2834;Ziefen;1303;Bezirk Liestal;6;VR Alters- und Pflegeregion Liestal;6;VR Alters- und Pflegeregion Liestal;1555;9;13;-4;96;98;-2;0;-6;1549
2015;2841;Anwil;1304;Bezirk Sissach;9;VR Farnsberg plus;7;Planungsregion Oberbaselbiet;579;6;6;0;37;26;11;0;11;590
2015;2842;Böckten;1304;Bezirk Sissach;7;VR Oberbaselbiet;7;Planungsregion Oberbaselbiet;815;7;6;1;55;78;-23;0;-22;793
2015;2843;Buckten;1304;Bezirk Sissach;8;VR Oberes Homburgertal;7;Planungsregion Oberbaselbiet;700;1;8;-7;62;58;4;0;-3;697
2015;2844;Buus;1304;Bezirk Sissach;9;VR Farnsberg plus;7;Planungsregion Oberbaselbiet;979;15;9;6;82;55;27;0;33;1012
2015;2845;Diepflingen;1304;Bezirk Sissach;7;VR Oberbaselbiet;7;Planungsregion Oberbaselbiet;689;10;6;4;78;49;29;0;33;722
2015;2846;Gelterkinden;1304;Bezirk Sissach;7;VR Oberbaselbiet;7;Planungsregion Oberbaselbiet;5900;55;55;0;450;324;126;0;126;6026
2015;2847;Häfelfingen;1304;Bezirk Sissach;8;VR Oberes Homburgertal;7;Planungsregion Oberbaselbiet;271;1;3;-2;37;33;4;0;2;273
2015;2848;Hemmiken;1304;Bezirk Sissach;9;VR Farnsberg plus;7;Planungsregion Oberbaselbiet;260;1;2;-1;38;20;18;0;17;277
2015;2849;Itingen;1304;Bezirk Sissach;7;VR Oberbaselbiet;7;Planungsregion Oberbaselbiet;2079;16;16;0;140;156;-16;0;-16;2063
2015;2850;Känerkinden;1304;Bezirk Sissach;8;VR Oberes Homburgertal;7;Planungsregion Oberbaselbiet;501;5;7;-2;53;28;25;0;23;524
2015;2851;Kilchberg (BL);1304;Bezirk Sissach;9;VR Farnsberg plus;7;Planungsregion Oberbaselbiet;157;3;1;2;4;6;-2;0;0;157
2015;2852;Läufelfingen;1304;Bezirk Sissach;8;VR Oberes Homburgertal;7;Planungsregion Oberbaselbiet;1296;17;8;9;101;93;8;0;17;1313
2015;2853;Maisprach;1304;Bezirk Sissach;9;VR Farnsberg plus;7;Planungsregion Oberbaselbiet;943;1;3;-2;89;73;16;0;14;957
2015;2854;Nusshof;1304;Bezirk Sissach;7;VR Oberbaselbiet;7;Planungsregion Oberbaselbiet;266;2;0;2;6;14;-8;0;-6;260
2015;2855;Oltingen;1304;Bezirk Sissach;9;VR Farnsberg plus;7;Planungsregion Oberbaselbiet;479;0;1;-1;32;26;6;0;5;484
2015;2856;Ormalingen;1304;Bezirk Sissach;7;VR Oberbaselbiet;7;Planungsregion Oberbaselbiet;2074;19;10;9;214;152;62;0;71;2145
2015;2857;Rickenbach (BL);1304;Bezirk Sissach;9;VR Farnsberg plus;7;Planungsregion Oberbaselbiet;565;5;3;2;55;25;30;0;32;597
2015;2858;Rothenfluh;1304;Bezirk Sissach;9;VR Farnsberg plus;7;Planungsregion Oberbaselbiet;788;6;6;0;48;50;-2;0;-2;786
2015;2859;Rümlingen;1304;Bezirk Sissach;8;VR Oberes Homburgertal;7;Planungsregion Oberbaselbiet;390;4;4;0;30;34;-4;0;-4;386
2015;2860;Rünenberg;1304;Bezirk Sissach;9;VR Farnsberg plus;7;Planungsregion Oberbaselbiet;782;5;10;-5;51;42;9;0;4;786
2015;2861;Sissach;1304;Bezirk Sissach;7;VR Oberbaselbiet;7;Planungsregion Oberbaselbiet;6490;74;53;21;620;456;164;0;185;6675
2015;2862;Tecknau;1304;Bezirk Sissach;7;VR Oberbaselbiet;7;Planungsregion Oberbaselbiet;866;5;3;2;67;72;-5;0;-3;863
2015;2863;Tenniken;1304;Bezirk Sissach;7;VR Oberbaselbiet;7;Planungsregion Oberbaselbiet;896;10;11;-1;76;70;6;0;5;901
2015;2864;Thürnen;1304;Bezirk Sissach;7;VR Oberbaselbiet;7;Planungsregion Oberbaselbiet;1401;11;11;0;124;113;11;0;11;1412
2015;2865;Wenslingen;1304;Bezirk Sissach;7;VR Oberbaselbiet;7;Planungsregion Oberbaselbiet;732;4;6;-2;47;43;4;0;2;734
2015;2866;Wintersingen;1304;Bezirk Sissach;9;VR Farnsberg plus;7;Planungsregion Oberbaselbiet;615;3;6;-3;43;40;3;0;0;615
2015;2867;Wittinsburg;1304;Bezirk Sissach;7;VR Oberbaselbiet;7;Planungsregion Oberbaselbiet;430;5;4;1;13;14;-1;0;0;430
2015;2868;Zeglingen;1304;Bezirk Sissach;9;VR Farnsberg plus;7;Planungsregion Oberbaselbiet;478;4;8;-4;26;12;14;0;10;488
2015;2869;Zunzgen;1304;Bezirk Sissach;7;VR Oberbaselbiet;7;Planungsregion Oberbaselbiet;2508;13;13;0;116;108;8;0;8;2516
2015;2881;Arboldswil;1305;Bezirk Waldenburg;10;VR Waldenburgertal plus;8;VR Waldenburgertal plus;554;3;3;0;34;20;14;0;14;568
2015;2882;Bennwil;1305;Bezirk Waldenburg;10;VR Waldenburgertal plus;8;VR Waldenburgertal plus;643;1;2;-1;45;34;11;0;10;653
2015;2883;Bretzwil;1305;Bezirk Waldenburg;10;VR Waldenburgertal plus;8;VR Waldenburgertal plus;759;7;5;2;56;39;17;0;19;778
2015;2884;Diegten;1305;Bezirk Waldenburg;7;VR Oberbaselbiet;7;Planungsregion Oberbaselbiet;1644;15;17;-2;90;111;-21;0;-23;1621
2015;2885;Eptingen;1305;Bezirk Waldenburg;7;VR Oberbaselbiet;7;Planungsregion Oberbaselbiet;537;7;7;0;42;41;1;0;1;538
2015;2886;Hölstein;1305;Bezirk Waldenburg;10;VR Waldenburgertal plus;8;VR Waldenburgertal plus;2384;35;12;23;195;171;24;0;47;2431
2015;2887;Lampenberg;1305;Bezirk Waldenburg;10;VR Waldenburgertal plus;8;VR Waldenburgertal plus;510;3;3;0;8;24;-16;0;-16;494
2015;2888;Langenbruck;1305;Bezirk Waldenburg;10;VR Waldenburgertal plus;8;VR Waldenburgertal plus;1014;5;8;-3;135;140;-5;0;-8;1006
2015;2889;Lauwil;1305;Bezirk Waldenburg;10;VR Waldenburgertal plus;8;VR Waldenburgertal plus;335;2;1;1;23;29;-6;0;-5;330
2015;2890;Liedertswil;1305;Bezirk Waldenburg;10;VR Waldenburgertal plus;8;VR Waldenburgertal plus;164;1;0;1;6;10;-4;0;-3;161
2015;2891;Niederdorf;1305;Bezirk Waldenburg;10;VR Waldenburgertal plus;8;VR Waldenburgertal plus;1778;21;12;9;152;128;24;0;33;1811
2015;2892;Oberdorf (BL);1305;Bezirk Waldenburg;10;VR Waldenburgertal plus;8;VR Waldenburgertal plus;2405;21;16;5;201;200;1;0;6;2411
2015;2893;Reigoldswil;1305;Bezirk Waldenburg;10;VR Waldenburgertal plus;8;VR Waldenburgertal plus;1603;3;14;-11;113;101;12;0;1;1604
2015;2894;Titterten;1305;Bezirk Waldenburg;10;VR Waldenburgertal plus;8;VR Waldenburgertal plus;420;5;8;-3;35;37;-2;0;-5;415
2015;2895;Waldenburg;1305;Bezirk Waldenburg;10;VR Waldenburgertal plus;8;VR Waldenburgertal plus;1201;2;7;-5;87;122;-35;0;-40;1161
2016;2761;Aesch (BL);1301;Bezirk Arlesheim;3;VR Alter Birsstadt;3;VR Alter Birsstadt;10257;84;76;8;713;749;-36;0;-28;10229
2016;2762;Allschwil;1301;Bezirk Arlesheim;1;VR Alter und Gesundheit ABS;1;VR Alter und Gesundheit ABS;20556;247;187;60;1564;1422;142;0;202;20758
2016;2763;Arlesheim;1301;Bezirk Arlesheim;3;VR Alter Birsstadt;3;VR Alter Birsstadt;9254;70;92;-22;650;555;95;0;73;9327
2016;2764;Biel-Benken;1301;Bezirk Arlesheim;4;VR BPA Leimental;4;VR BPA Leimental;3434;29;29;0;216;225;-9;0;-9;3425
2016;2765;Binningen;1301;Bezirk Arlesheim;1;VR Alter und Gesundheit ABS;1;VR Alter und Gesundheit ABS;15200;161;150;11;1490;1197;293;0;304;15504
2016;2766;Birsfelden;1301;Bezirk Arlesheim;2;VR APG Rheintal;2;VR APG Rheintal;10427;120;111;9;856;764;92;0;101;10528
2016;2767;Bottmingen;1301;Bezirk Arlesheim;4;VR BPA Leimental;4;VR BPA Leimental;6502;59;63;-4;624;556;68;0;64;6566
2016;2768;Ettingen;1301;Bezirk Arlesheim;4;VR BPA Leimental;4;VR BPA Leimental;5004;50;40;10;421;366;55;0;65;5069
2016;2769;Münchenstein;1301;Bezirk Arlesheim;3;VR Alter Birsstadt;3;VR Alter Birsstadt;11986;118;114;4;1094;899;195;0;199;12185
2016;2770;Muttenz;1301;Bezirk Arlesheim;2;VR APG Rheintal;2;VR APG Rheintal;17728;152;166;-14;1171;1090;81;0;67;17795
2016;2771;Oberwil (BL);1301;Bezirk Arlesheim;4;VR BPA Leimental;4;VR BPA Leimental;11156;91;84;7;894;760;134;0;141;11297
2016;2772;Pfeffingen;1301;Bezirk Arlesheim;3;VR Alter Birsstadt;3;VR Alter Birsstadt;2373;23;14;9;151;162;-11;0;-2;2371
2016;2773;Reinach (BL);1301;Bezirk Arlesheim;3;VR Alter Birsstadt;3;VR Alter Birsstadt;18955;151;171;-20;1431;1264;167;0;147;19102
2016;2774;Schönenbuch;1301;Bezirk Arlesheim;1;VR Alter und Gesundheit ABS;1;VR Alter und Gesundheit ABS;1387;11;13;-2;109;100;9;0;7;1394
2016;2775;Therwil;1301;Bezirk Arlesheim;4;VR BPA Leimental;4;VR BPA Leimental;10085;88;72;16;617;687;-70;0;-54;10031
2016;2781;Blauen;1302;Bezirk Laufen;5;VR APG Laufental;5;VR APG Laufental;698;7;5;2;39;44;-5;0;-3;695
2016;2782;Brislach;1302;Bezirk Laufen;5;VR APG Laufental;5;VR APG Laufental;1619;11;11;0;106;81;25;0;25;1644
2016;2783;Burg im Leimental;1302;Bezirk Laufen;4;VR BPA Leimental;4;VR BPA Leimental;263;1;0;1;20;22;-2;0;-1;262
2016;2784;Dittingen;1302;Bezirk Laufen;5;VR APG Laufental;5;VR APG Laufental;741;5;7;-2;66;58;8;0;6;747
2016;2785;Duggingen;1302;Bezirk Laufen;3;VR Alter Birsstadt;3;VR Alter Birsstadt;1528;8;5;3;139;117;22;0;25;1553
2016;2786;Grellingen;1302;Bezirk Laufen;5;VR APG Laufental;5;VR APG Laufental;1853;21;13;8;160;168;-8;0;0;1853
2016;2787;Laufen;1302;Bezirk Laufen;5;VR APG Laufental;5;VR APG Laufental;5566;46;60;-14;428;409;19;0;5;5571
2016;2788;Liesberg;1302;Bezirk Laufen;5;VR APG Laufental;5;VR APG Laufental;1175;6;15;-9;58;85;-27;0;-36;1139
2016;2789;Nenzlingen;1302;Bezirk Laufen;5;VR APG Laufental;5;VR APG Laufental;424;3;5;-2;30;15;15;0;13;437
2016;2790;Roggenburg;1302;Bezirk Laufen;5;VR APG Laufental;5;VR APG Laufental;280;2;1;1;15;15;0;0;1;281
2016;2791;Röschenz;1302;Bezirk Laufen;5;VR APG Laufental;5;VR APG Laufental;1852;13;15;-2;101;114;-13;0;-15;1837
2016;2792;Wahlen;1302;Bezirk Laufen;5;VR APG Laufental;5;VR APG Laufental;1416;17;14;3;100;94;6;0;9;1425
2016;2793;Zwingen;1302;Bezirk Laufen;5;VR APG Laufental;5;VR APG Laufental;2280;30;19;11;224;233;-9;0;2;2282
2016;2821;Arisdorf;1303;Bezirk Liestal;6;VR Alters- und Pflegeregion Liestal;6;VR Alters- und Pflegeregion Liestal;1664;12;12;0;109;111;-2;0;-2;1662
2016;2822;Augst;1303;Bezirk Liestal;2;VR APG Rheintal;2;VR APG Rheintal;955;9;8;1;167;110;57;0;58;1013
2016;2823;Bubendorf;1303;Bezirk Liestal;6;VR Alters- und Pflegeregion Liestal;6;VR Alters- und Pflegeregion Liestal;4410;29;38;-9;302;292;10;0;1;4411
2016;2824;Frenkendorf;1303;Bezirk Liestal;6;VR Alters- und Pflegeregion Liestal;6;VR Alters- und Pflegeregion Liestal;6523;59;47;12;512;508;4;0;16;6539
2016;2825;Füllinsdorf;1303;Bezirk Liestal;6;VR Alters- und Pflegeregion Liestal;6;VR Alters- und Pflegeregion Liestal;4417;37;51;-14;373;339;34;0;20;4437
2016;2826;Giebenach;1303;Bezirk Liestal;2;VR APG Rheintal;2;VR APG Rheintal;1046;5;6;-1;79;80;-1;0;-2;1044
2016;2827;Hersberg;1303;Bezirk Liestal;6;VR Alters- und Pflegeregion Liestal;6;VR Alters- und Pflegeregion Liestal;327;5;3;2;26;25;1;0;3;330
2016;2828;Lausen;1303;Bezirk Liestal;6;VR Alters- und Pflegeregion Liestal;6;VR Alters- und Pflegeregion Liestal;5035;56;38;18;393;368;25;0;43;5078
2016;2829;Liestal;1303;Bezirk Liestal;6;VR Alters- und Pflegeregion Liestal;6;VR Alters- und Pflegeregion Liestal;14134;141;130;11;1077;1047;30;0;41;14175
2016;2830;Lupsingen;1303;Bezirk Liestal;6;VR Alters- und Pflegeregion Liestal;6;VR Alters- und Pflegeregion Liestal;1431;12;6;6;80;104;-24;0;-18;1413
2016;2831;Pratteln;1303;Bezirk Liestal;2;VR APG Rheintal;2;VR APG Rheintal;15991;158;142;16;1369;1140;229;0;245;16236
2016;2832;Ramlinsburg;1303;Bezirk Liestal;10;VR Waldenburgertal plus;8;VR Waldenburgertal plus;698;3;6;-3;45;39;6;0;3;701
2016;2833;Seltisberg;1303;Bezirk Liestal;6;VR Alters- und Pflegeregion Liestal;6;VR Alters- und Pflegeregion Liestal;1317;13;11;2;55;67;-12;0;-10;1307
2016;2834;Ziefen;1303;Bezirk Liestal;6;VR Alters- und Pflegeregion Liestal;6;VR Alters- und Pflegeregion Liestal;1549;14;15;-1;102;103;-1;0;-2;1547
2016;2841;Anwil;1304;Bezirk Sissach;9;VR Farnsberg plus;7;Planungsregion Oberbaselbiet;590;2;4;-2;22;23;-1;0;-3;587
2016;2842;Böckten;1304;Bezirk Sissach;7;VR Oberbaselbiet;7;Planungsregion Oberbaselbiet;793;9;3;6;59;57;2;0;8;801
2016;2843;Buckten;1304;Bezirk Sissach;8;VR Oberes Homburgertal;7;Planungsregion Oberbaselbiet;697;6;5;1;46;46;0;0;1;698
2016;2844;Buus;1304;Bezirk Sissach;9;VR Farnsberg plus;7;Planungsregion Oberbaselbiet;1012;12;8;4;72;80;-8;0;-4;1008
2016;2845;Diepflingen;1304;Bezirk Sissach;7;VR Oberbaselbiet;7;Planungsregion Oberbaselbiet;722;9;4;5;82;58;24;0;29;751
2016;2846;Gelterkinden;1304;Bezirk Sissach;7;VR Oberbaselbiet;7;Planungsregion Oberbaselbiet;6026;64;52;12;375;387;-12;0;0;6026
2016;2847;Häfelfingen;1304;Bezirk Sissach;8;VR Oberes Homburgertal;7;Planungsregion Oberbaselbiet;273;1;2;-1;18;35;-17;0;-18;255
2016;2848;Hemmiken;1304;Bezirk Sissach;9;VR Farnsberg plus;7;Planungsregion Oberbaselbiet;277;4;4;0;10;24;-14;0;-14;263
2016;2849;Itingen;1304;Bezirk Sissach;7;VR Oberbaselbiet;7;Planungsregion Oberbaselbiet;2063;23;11;12;160;128;32;0;44;2107
2016;2850;Känerkinden;1304;Bezirk Sissach;8;VR Oberes Homburgertal;7;Planungsregion Oberbaselbiet;524;1;3;-2;41;36;5;0;3;527
2016;2851;Kilchberg (BL);1304;Bezirk Sissach;9;VR Farnsberg plus;7;Planungsregion Oberbaselbiet;157;0;0;0;10;8;2;0;2;159
2016;2852;Läufelfingen;1304;Bezirk Sissach;8;VR Oberes Homburgertal;7;Planungsregion Oberbaselbiet;1313;10;15;-5;82;73;9;0;4;1317
2016;2853;Maisprach;1304;Bezirk Sissach;9;VR Farnsberg plus;7;Planungsregion Oberbaselbiet;957;5;6;-1;78;87;-9;0;-10;947
2016;2854;Nusshof;1304;Bezirk Sissach;7;VR Oberbaselbiet;7;Planungsregion Oberbaselbiet;260;1;3;-2;6;6;0;0;-2;258
2016;2855;Oltingen;1304;Bezirk Sissach;9;VR Farnsberg plus;7;Planungsregion Oberbaselbiet;484;4;4;0;22;18;4;0;4;488
2016;2856;Ormalingen;1304;Bezirk Sissach;7;VR Oberbaselbiet;7;Planungsregion Oberbaselbiet;2145;28;22;6;192;158;34;0;40;2185
2016;2857;Rickenbach (BL);1304;Bezirk Sissach;9;VR Farnsberg plus;7;Planungsregion Oberbaselbiet;597;2;4;-2;55;45;10;0;8;605
2016;2858;Rothenfluh;1304;Bezirk Sissach;9;VR Farnsberg plus;7;Planungsregion Oberbaselbiet;786;3;5;-2;45;60;-15;0;-17;769
2016;2859;Rümlingen;1304;Bezirk Sissach;8;VR Oberes Homburgertal;7;Planungsregion Oberbaselbiet;386;5;1;4;33;34;-1;0;3;389
2016;2860;Rünenberg;1304;Bezirk Sissach;9;VR Farnsberg plus;7;Planungsregion Oberbaselbiet;786;3;7;-4;48;46;2;0;-2;784
2016;2861;Sissach;1304;Bezirk Sissach;7;VR Oberbaselbiet;7;Planungsregion Oberbaselbiet;6675;87;44;43;516;469;47;0;90;6765
2016;2862;Tecknau;1304;Bezirk Sissach;7;VR Oberbaselbiet;7;Planungsregion Oberbaselbiet;863;8;7;1;58;55;3;0;4;867
2016;2863;Tenniken;1304;Bezirk Sissach;7;VR Oberbaselbiet;7;Planungsregion Oberbaselbiet;901;7;5;2;85;52;33;0;35;936
2016;2864;Thürnen;1304;Bezirk Sissach;7;VR Oberbaselbiet;7;Planungsregion Oberbaselbiet;1412;11;9;2;127;121;6;0;8;1420
2016;2865;Wenslingen;1304;Bezirk Sissach;7;VR Oberbaselbiet;7;Planungsregion Oberbaselbiet;734;8;12;-4;25;38;-13;0;-17;717
2016;2866;Wintersingen;1304;Bezirk Sissach;9;VR Farnsberg plus;7;Planungsregion Oberbaselbiet;615;4;6;-2;33;34;-1;0;-3;612
2016;2867;Wittinsburg;1304;Bezirk Sissach;7;VR Oberbaselbiet;7;Planungsregion Oberbaselbiet;430;1;0;1;20;28;-8;0;-7;423
2016;2868;Zeglingen;1304;Bezirk Sissach;9;VR Farnsberg plus;7;Planungsregion Oberbaselbiet;488;8;7;1;19;20;-1;0;0;488
2016;2869;Zunzgen;1304;Bezirk Sissach;7;VR Oberbaselbiet;7;Planungsregion Oberbaselbiet;2516;25;15;10;164;178;-14;0;-4;2512
2016;2881;Arboldswil;1305;Bezirk Waldenburg;10;VR Waldenburgertal plus;8;VR Waldenburgertal plus;568;2;4;-2;24;28;-4;0;-6;562
2016;2882;Bennwil;1305;Bezirk Waldenburg;10;VR Waldenburgertal plus;8;VR Waldenburgertal plus;653;7;5;2;37;40;-3;0;-1;652
2016;2883;Bretzwil;1305;Bezirk Waldenburg;10;VR Waldenburgertal plus;8;VR Waldenburgertal plus;778;6;5;1;43;45;-2;0;-1;777
2016;2884;Diegten;1305;Bezirk Waldenburg;7;VR Oberbaselbiet;7;Planungsregion Oberbaselbiet;1621;12;8;4;111;113;-2;0;2;1623
2016;2885;Eptingen;1305;Bezirk Waldenburg;7;VR Oberbaselbiet;7;Planungsregion Oberbaselbiet;538;2;6;-4;36;45;-9;0;-13;525
2016;2886;Hölstein;1305;Bezirk Waldenburg;10;VR Waldenburgertal plus;8;VR Waldenburgertal plus;2431;14;13;1;216;181;35;0;36;2467
2016;2887;Lampenberg;1305;Bezirk Waldenburg;10;VR Waldenburgertal plus;8;VR Waldenburgertal plus;494;4;6;-2;46;34;12;0;10;504
2016;2888;Langenbruck;1305;Bezirk Waldenburg;10;VR Waldenburgertal plus;8;VR Waldenburgertal plus;1006;5;11;-6;101;130;-29;0;-35;971
2016;2889;Lauwil;1305;Bezirk Waldenburg;10;VR Waldenburgertal plus;8;VR Waldenburgertal plus;330;3;6;-3;26;14;12;0;9;339
2016;2890;Liedertswil;1305;Bezirk Waldenburg;10;VR Waldenburgertal plus;8;VR Waldenburgertal plus;161;0;1;-1;9;7;2;0;1;162
2016;2891;Niederdorf;1305;Bezirk Waldenburg;10;VR Waldenburgertal plus;8;VR Waldenburgertal plus;1811;17;18;-1;151;129;22;0;21;1832
2016;2892;Oberdorf (BL);1305;Bezirk Waldenburg;10;VR Waldenburgertal plus;8;VR Waldenburgertal plus;2411;22;22;0;229;192;37;0;37;2448
2016;2893;Reigoldswil;1305;Bezirk Waldenburg;10;VR Waldenburgertal plus;8;VR Waldenburgertal plus;1604;15;12;3;109;117;-8;0;-5;1599
2016;2894;Titterten;1305;Bezirk Waldenburg;10;VR Waldenburgertal plus;8;VR Waldenburgertal plus;415;2;1;1;14;22;-8;0;-7;408
2016;2895;Waldenburg;1305;Bezirk Waldenburg;10;VR Waldenburgertal plus;8;VR Waldenburgertal plus;1161;8;9;-1;131;101;30;0;29;1190
2017;2761;Aesch (BL);1301;Bezirk Arlesheim;3;VR Alter Birsstadt;3;VR Alter Birsstadt;10229;81;87;-6;730;666;64;0;58;10287
2017;2762;Allschwil;1301;Bezirk Arlesheim;1;VR Alter und Gesundheit ABS;1;VR Alter und Gesundheit ABS;20758;213;214;-1;1622;1356;266;0;265;21023
2017;2763;Arlesheim;1301;Bezirk Arlesheim;3;VR Alter Birsstadt;3;VR Alter Birsstadt;9327;74;98;-24;518;575;-57;0;-81;9246
2017;2764;Biel-Benken;1301;Bezirk Arlesheim;4;VR BPA Leimental;4;VR BPA Leimental;3425;23;22;1;251;230;21;0;22;3447
2017;2765;Binningen;1301;Bezirk Arlesheim;1;VR Alter und Gesundheit ABS;1;VR Alter und Gesundheit ABS;15504;167;152;15;1199;1055;144;0;159;15663
2017;2766;Birsfelden;1301;Bezirk Arlesheim;2;VR APG Rheintal;2;VR APG Rheintal;10528;109;115;-6;694;751;-57;0;-63;10465
2017;2767;Bottmingen;1301;Bezirk Arlesheim;4;VR BPA Leimental;4;VR BPA Leimental;6566;62;42;20;590;541;49;0;69;6635
2017;2768;Ettingen;1301;Bezirk Arlesheim;4;VR BPA Leimental;4;VR BPA Leimental;5069;45;35;10;420;314;106;0;116;5185
2017;2769;Münchenstein;1301;Bezirk Arlesheim;3;VR Alter Birsstadt;3;VR Alter Birsstadt;12185;126;128;-2;1023;946;77;0;75;12260
2017;2770;Muttenz;1301;Bezirk Arlesheim;2;VR APG Rheintal;2;VR APG Rheintal;17795;167;174;-7;1097;1006;91;0;84;17879
2017;2771;Oberwil (BL);1301;Bezirk Arlesheim;4;VR BPA Leimental;4;VR BPA Leimental;11297;113;92;21;811;860;-49;0;-28;11269
2017;2772;Pfeffingen;1301;Bezirk Arlesheim;3;VR Alter Birsstadt;3;VR Alter Birsstadt;2371;19;14;5;137;141;-4;0;1;2372
2017;2773;Reinach (BL);1301;Bezirk Arlesheim;3;VR Alter Birsstadt;3;VR Alter Birsstadt;19102;153;173;-20;1336;1228;108;0;88;19190
2017;2774;Schönenbuch;1301;Bezirk Arlesheim;1;VR Alter und Gesundheit ABS;1;VR Alter und Gesundheit ABS;1394;12;12;0;74;77;-3;0;-3;1391
2017;2775;Therwil;1301;Bezirk Arlesheim;4;VR BPA Leimental;4;VR BPA Leimental;10031;80;71;9;561;633;-72;0;-63;9968
2017;2781;Blauen;1302;Bezirk Laufen;5;VR APG Laufental;5;VR APG Laufental;695;5;8;-3;29;29;0;0;-3;692
2017;2782;Brislach;1302;Bezirk Laufen;5;VR APG Laufental;5;VR APG Laufental;1644;16;17;-1;86;84;2;0;1;1645
2017;2783;Burg im Leimental;1302;Bezirk Laufen;4;VR BPA Leimental;4;VR BPA Leimental;262;2;2;0;20;17;3;0;3;265
2017;2784;Dittingen;1302;Bezirk Laufen;5;VR APG Laufental;5;VR APG Laufental;747;4;8;-4;58;68;-10;0;-14;733
2017;2785;Duggingen;1302;Bezirk Laufen;3;VR Alter Birsstadt;3;VR Alter Birsstadt;1553;13;9;4;168;151;17;0;21;1574
2017;2786;Grellingen;1302;Bezirk Laufen;5;VR APG Laufental;5;VR APG Laufental;1853;17;17;0;156;173;-17;0;-17;1836
2017;2787;Laufen;1302;Bezirk Laufen;5;VR APG Laufental;5;VR APG Laufental;5571;54;55;-1;414;397;17;0;16;5587
2017;2788;Liesberg;1302;Bezirk Laufen;5;VR APG Laufental;5;VR APG Laufental;1139;10;11;-1;75;56;19;0;18;1157
2017;2789;Nenzlingen;1302;Bezirk Laufen;5;VR APG Laufental;5;VR APG Laufental;437;0;6;-6;32;30;2;0;-4;433
2017;2790;Roggenburg;1302;Bezirk Laufen;5;VR APG Laufental;5;VR APG Laufental;281;3;3;0;15;23;-8;0;-8;273
2017;2791;Röschenz;1302;Bezirk Laufen;5;VR APG Laufental;5;VR APG Laufental;1837;23;7;16;124;90;34;0;50;1887
2017;2792;Wahlen;1302;Bezirk Laufen;5;VR APG Laufental;5;VR APG Laufental;1425;10;12;-2;100;99;1;0;-1;1424
2017;2793;Zwingen;1302;Bezirk Laufen;5;VR APG Laufental;5;VR APG Laufental;2282;30;19;11;255;190;65;0;76;2358
2017;2821;Arisdorf;1303;Bezirk Liestal;6;VR Alters- und Pflegeregion Liestal;6;VR Alters- und Pflegeregion Liestal;1662;4;8;-4;86;100;-14;0;-18;1644
2017;2822;Augst;1303;Bezirk Liestal;2;VR APG Rheintal;2;VR APG Rheintal;1013;11;9;2;104;99;5;0;7;1020
2017;2823;Bubendorf;1303;Bezirk Liestal;6;VR Alters- und Pflegeregion Liestal;6;VR Alters- und Pflegeregion Liestal;4411;38;35;3;241;304;-63;0;-60;4351
2017;2824;Frenkendorf;1303;Bezirk Liestal;6;VR Alters- und Pflegeregion Liestal;6;VR Alters- und Pflegeregion Liestal;6539;72;47;25;479;533;-54;0;-29;6510
2017;2825;Füllinsdorf;1303;Bezirk Liestal;6;VR Alters- und Pflegeregion Liestal;6;VR Alters- und Pflegeregion Liestal;4437;38;44;-6;397;345;52;0;46;4483
2017;2826;Giebenach;1303;Bezirk Liestal;2;VR APG Rheintal;2;VR APG Rheintal;1044;12;3;9;62;79;-17;0;-8;1036
2017;2827;Hersberg;1303;Bezirk Liestal;6;VR Alters- und Pflegeregion Liestal;6;VR Alters- und Pflegeregion Liestal;330;2;1;1;16;39;-23;0;-22;308
2017;2828;Lausen;1303;Bezirk Liestal;6;VR Alters- und Pflegeregion Liestal;6;VR Alters- und Pflegeregion Liestal;5078;48;41;7;443;360;83;0;90;5168
2017;2829;Liestal;1303;Bezirk Liestal;6;VR Alters- und Pflegeregion Liestal;6;VR Alters- und Pflegeregion Liestal;14175;163;115;48;1213;1159;54;0;102;14277
2017;2830;Lupsingen;1303;Bezirk Liestal;6;VR Alters- und Pflegeregion Liestal;6;VR Alters- und Pflegeregion Liestal;1413;10;9;1;89;74;15;0;16;1429
2017;2831;Pratteln;1303;Bezirk Liestal;2;VR APG Rheintal;2;VR APG Rheintal;16236;173;130;43;1420;1158;262;0;305;16541
2017;2832;Ramlinsburg;1303;Bezirk Liestal;10;VR Waldenburgertal plus;8;VR Waldenburgertal plus;701;5;3;2;52;35;17;0;19;720
2017;2833;Seltisberg;1303;Bezirk Liestal;6;VR Alters- und Pflegeregion Liestal;6;VR Alters- und Pflegeregion Liestal;1307;10;8;2;71;71;0;0;2;1309
2017;2834;Ziefen;1303;Bezirk Liestal;6;VR Alters- und Pflegeregion Liestal;6;VR Alters- und Pflegeregion Liestal;1547;16;13;3;115;85;30;0;33;1580
2017;2841;Anwil;1304;Bezirk Sissach;9;VR Farnsberg plus;7;Planungsregion Oberbaselbiet;587;10;4;6;18;35;-17;0;-11;576
2017;2842;Böckten;1304;Bezirk Sissach;7;VR Oberbaselbiet;7;Planungsregion Oberbaselbiet;801;3;6;-3;70;58;12;0;9;810
2017;2843;Buckten;1304;Bezirk Sissach;8;VR Oberes Homburgertal;7;Planungsregion Oberbaselbiet;698;4;9;-5;51;47;4;0;-1;697
2017;2844;Buus;1304;Bezirk Sissach;9;VR Farnsberg plus;7;Planungsregion Oberbaselbiet;1008;8;8;0;118;80;38;0;38;1046
2017;2845;Diepflingen;1304;Bezirk Sissach;7;VR Oberbaselbiet;7;Planungsregion Oberbaselbiet;751;5;7;-2;53;60;-7;0;-9;742
2017;2846;Gelterkinden;1304;Bezirk Sissach;7;VR Oberbaselbiet;7;Planungsregion Oberbaselbiet;6026;59;50;9;468;390;78;0;87;6113
2017;2847;Häfelfingen;1304;Bezirk Sissach;8;VR Oberes Homburgertal;7;Planungsregion Oberbaselbiet;255;2;2;0;33;15;18;0;18;273
2017;2848;Hemmiken;1304;Bezirk Sissach;9;VR Farnsberg plus;7;Planungsregion Oberbaselbiet;263;2;2;0;15;24;-9;0;-9;254
2017;2849;Itingen;1304;Bezirk Sissach;7;VR Oberbaselbiet;7;Planungsregion Oberbaselbiet;2107;23;11;12;131;153;-22;0;-10;2097
2017;2850;Känerkinden;1304;Bezirk Sissach;8;VR Oberes Homburgertal;7;Planungsregion Oberbaselbiet;527;5;8;-3;43;32;11;0;8;535
2017;2851;Kilchberg (BL);1304;Bezirk Sissach;9;VR Farnsberg plus;7;Planungsregion Oberbaselbiet;159;1;1;0;9;4;5;0;5;164
2017;2852;Läufelfingen;1304;Bezirk Sissach;8;VR Oberes Homburgertal;7;Planungsregion Oberbaselbiet;1317;9;12;-3;77;69;8;0;5;1322
2017;2853;Maisprach;1304;Bezirk Sissach;9;VR Farnsberg plus;7;Planungsregion Oberbaselbiet;947;9;6;3;94;98;-4;0;-1;946
2017;2854;Nusshof;1304;Bezirk Sissach;7;VR Oberbaselbiet;7;Planungsregion Oberbaselbiet;258;0;1;-1;11;12;-1;0;-2;256
2017;2855;Oltingen;1304;Bezirk Sissach;9;VR Farnsberg plus;7;Planungsregion Oberbaselbiet;488;2;2;0;22;39;-17;0;-17;471
2017;2856;Ormalingen;1304;Bezirk Sissach;7;VR Oberbaselbiet;7;Planungsregion Oberbaselbiet;2185;20;15;5;205;181;24;0;29;2214
2017;2857;Rickenbach (BL);1304;Bezirk Sissach;9;VR Farnsberg plus;7;Planungsregion Oberbaselbiet;605;2;1;1;48;53;-5;0;-4;601
2017;2858;Rothenfluh;1304;Bezirk Sissach;9;VR Farnsberg plus;7;Planungsregion Oberbaselbiet;769;7;3;4;56;39;17;0;21;790
2017;2859;Rümlingen;1304;Bezirk Sissach;8;VR Oberes Homburgertal;7;Planungsregion Oberbaselbiet;389;5;4;1;28;28;0;0;1;390
2017;2860;Rünenberg;1304;Bezirk Sissach;9;VR Farnsberg plus;7;Planungsregion Oberbaselbiet;784;12;8;4;33;39;-6;0;-2;782
2017;2861;Sissach;1304;Bezirk Sissach;7;VR Oberbaselbiet;7;Planungsregion Oberbaselbiet;6765;72;55;17;486;581;-95;0;-78;6687
2017;2862;Tecknau;1304;Bezirk Sissach;7;VR Oberbaselbiet;7;Planungsregion Oberbaselbiet;867;7;4;3;63;66;-3;0;0;867
2017;2863;Tenniken;1304;Bezirk Sissach;7;VR Oberbaselbiet;7;Planungsregion Oberbaselbiet;936;9;6;3;48;69;-21;0;-18;918
2017;2864;Thürnen;1304;Bezirk Sissach;7;VR Oberbaselbiet;7;Planungsregion Oberbaselbiet;1420;12;9;3;102;123;-21;0;-18;1402
2017;2865;Wenslingen;1304;Bezirk Sissach;7;VR Oberbaselbiet;7;Planungsregion Oberbaselbiet;717;3;4;-1;47;35;12;0;11;728
2017;2866;Wintersingen;1304;Bezirk Sissach;9;VR Farnsberg plus;7;Planungsregion Oberbaselbiet;612;6;6;0;31;36;-5;0;-5;607
2017;2867;Wittinsburg;1304;Bezirk Sissach;7;VR Oberbaselbiet;7;Planungsregion Oberbaselbiet;423;4;5;-1;27;15;12;0;11;434
2017;2868;Zeglingen;1304;Bezirk Sissach;9;VR Farnsberg plus;7;Planungsregion Oberbaselbiet;488;1;2;-1;29;25;4;0;3;491
2017;2869;Zunzgen;1304;Bezirk Sissach;7;VR Oberbaselbiet;7;Planungsregion Oberbaselbiet;2512;19;13;6;150;158;-8;0;-2;2510
2017;2881;Arboldswil;1305;Bezirk Waldenburg;10;VR Waldenburgertal plus;8;VR Waldenburgertal plus;562;5;5;0;33;28;5;0;5;567
2017;2882;Bennwil;1305;Bezirk Waldenburg;10;VR Waldenburgertal plus;8;VR Waldenburgertal plus;652;8;7;1;67;50;17;0;18;670
2017;2883;Bretzwil;1305;Bezirk Waldenburg;10;VR Waldenburgertal plus;8;VR Waldenburgertal plus;777;6;4;2;42;38;4;0;6;783
2017;2884;Diegten;1305;Bezirk Waldenburg;7;VR Oberbaselbiet;7;Planungsregion Oberbaselbiet;1623;12;13;-1;128;85;43;-1;41;1664
2017;2885;Eptingen;1305;Bezirk Waldenburg;7;VR Oberbaselbiet;7;Planungsregion Oberbaselbiet;525;7;3;4;34;25;9;0;13;538
2017;2886;Hölstein;1305;Bezirk Waldenburg;10;VR Waldenburgertal plus;8;VR Waldenburgertal plus;2467;33;14;19;207;189;18;0;37;2504
2017;2887;Lampenberg;1305;Bezirk Waldenburg;10;VR Waldenburgertal plus;8;VR Waldenburgertal plus;504;4;4;0;24;22;2;0;2;506
2017;2888;Langenbruck;1305;Bezirk Waldenburg;10;VR Waldenburgertal plus;8;VR Waldenburgertal plus;971;8;12;-4;114;100;14;0;10;981
2017;2889;Lauwil;1305;Bezirk Waldenburg;10;VR Waldenburgertal plus;8;VR Waldenburgertal plus;339;2;5;-3;7;21;-14;0;-17;322
2017;2890;Liedertswil;1305;Bezirk Waldenburg;10;VR Waldenburgertal plus;8;VR Waldenburgertal plus;162;2;3;-1;9;5;4;0;3;165
2017;2891;Niederdorf;1305;Bezirk Waldenburg;10;VR Waldenburgertal plus;8;VR Waldenburgertal plus;1832;23;18;5;147;171;-24;0;-19;1813
2017;2892;Oberdorf (BL);1305;Bezirk Waldenburg;10;VR Waldenburgertal plus;8;VR Waldenburgertal plus;2448;20;24;-4;177;194;-17;0;-21;2427
2017;2893;Reigoldswil;1305;Bezirk Waldenburg;10;VR Waldenburgertal plus;8;VR Waldenburgertal plus;1599;16;9;7;113;99;14;0;21;1620
2017;2894;Titterten;1305;Bezirk Waldenburg;10;VR Waldenburgertal plus;8;VR Waldenburgertal plus;408;3;3;0;26;20;6;0;6;414
2017;2895;Waldenburg;1305;Bezirk Waldenburg;10;VR Waldenburgertal plus;8;VR Waldenburgertal plus;1190;14;9;5;98;149;-51;0;-46;1144
2018;2761;Aesch (BL);1301;Bezirk Arlesheim;3;VR Alter Birsstadt;3;VR Alter Birsstadt;10287;98;76;22;821;724;97;0;119;10406
2018;2762;Allschwil;1301;Bezirk Arlesheim;1;VR Alter und Gesundheit ABS;1;VR Alter und Gesundheit ABS;21023;236;215;21;1562;1364;198;0;219;21242
2018;2763;Arlesheim;1301;Bezirk Arlesheim;3;VR Alter Birsstadt;3;VR Alter Birsstadt;9246;59;93;-34;573;626;-53;0;-87;9159
2018;2764;Biel-Benken;1301;Bezirk Arlesheim;4;VR BPA Leimental;4;VR BPA Leimental;3447;21;24;-3;217;215;2;0;-1;3446
2018;2765;Binningen;1301;Bezirk Arlesheim;1;VR Alter und Gesundheit ABS;1;VR Alter und Gesundheit ABS;15663;156;140;16;1283;1208;75;0;91;15754
2018;2766;Birsfelden;1301;Bezirk Arlesheim;2;VR APG Rheintal;2;VR APG Rheintal;10465;98;136;-38;735;812;-77;0;-115;10350
2018;2767;Bottmingen;1301;Bezirk Arlesheim;4;VR BPA Leimental;4;VR BPA Leimental;6635;59;63;-4;631;525;106;0;102;6737
2018;2768;Ettingen;1301;Bezirk Arlesheim;4;VR BPA Leimental;4;VR BPA Leimental;5185;36;33;3;411;309;102;0;105;5290
2018;2769;Münchenstein;1301;Bezirk Arlesheim;3;VR Alter Birsstadt;3;VR Alter Birsstadt;12260;134;127;7;842;948;-106;0;-99;12161
2018;2770;Muttenz;1301;Bezirk Arlesheim;2;VR APG Rheintal;2;VR APG Rheintal;17879;166;180;-14;1084;1069;15;0;1;17880
2018;2771;Oberwil (BL);1301;Bezirk Arlesheim;4;VR BPA Leimental;4;VR BPA Leimental;11269;106;87;19;810;905;-95;0;-76;11193
2018;2772;Pfeffingen;1301;Bezirk Arlesheim;3;VR Alter Birsstadt;3;VR Alter Birsstadt;2372;13;17;-4;145;165;-20;0;-24;2348
2018;2773;Reinach (BL);1301;Bezirk Arlesheim;3;VR Alter Birsstadt;3;VR Alter Birsstadt;19190;148;143;5;1233;1160;73;-1;77;19267
2018;2774;Schönenbuch;1301;Bezirk Arlesheim;1;VR Alter und Gesundheit ABS;1;VR Alter und Gesundheit ABS;1391;12;11;1;114;99;15;0;16;1407
2018;2775;Therwil;1301;Bezirk Arlesheim;4;VR BPA Leimental;4;VR BPA Leimental;9968;85;90;-5;565;632;-67;0;-72;9896
2018;2781;Blauen;1302;Bezirk Laufen;5;VR APG Laufental;5;VR APG Laufental;692;4;10;-6;32;25;7;0;1;693
2018;2782;Brislach;1302;Bezirk Laufen;5;VR APG Laufental;5;VR APG Laufental;1645;15;10;5;108;99;9;0;14;1659
2018;2783;Burg im Leimental;1302;Bezirk Laufen;4;VR BPA Leimental;4;VR BPA Leimental;265;0;4;-4;20;16;4;0;0;265
2018;2784;Dittingen;1302;Bezirk Laufen;5;VR APG Laufental;5;VR APG Laufental;733;4;11;-7;66;61;5;0;-2;731
2018;2785;Duggingen;1302;Bezirk Laufen;3;VR Alter Birsstadt;3;VR Alter Birsstadt;1574;10;7;3;108;135;-27;0;-24;1550
2018;2786;Grellingen;1302;Bezirk Laufen;5;VR APG Laufental;5;VR APG Laufental;1836;17;9;8;144;139;5;0;13;1849
2018;2787;Laufen;1302;Bezirk Laufen;5;VR APG Laufental;5;VR APG Laufental;5587;48;38;10;420;375;45;0;55;5642
2018;2788;Liesberg;1302;Bezirk Laufen;5;VR APG Laufental;5;VR APG Laufental;1157;9;12;-3;59;76;-17;0;-20;1137
2018;2789;Nenzlingen;1302;Bezirk Laufen;5;VR APG Laufental;5;VR APG Laufental;433;2;2;0;35;23;12;0;12;445
2018;2790;Roggenburg;1302;Bezirk Laufen;5;VR APG Laufental;5;VR APG Laufental;273;2;0;2;21;16;5;0;7;280
2018;2791;Röschenz;1302;Bezirk Laufen;5;VR APG Laufental;5;VR APG Laufental;1887;14;16;-2;89;101;-12;0;-14;1873
2018;2792;Wahlen;1302;Bezirk Laufen;5;VR APG Laufental;5;VR APG Laufental;1424;13;9;4;111;76;35;0;39;1463
2018;2793;Zwingen;1302;Bezirk Laufen;5;VR APG Laufental;5;VR APG Laufental;2358;20;19;1;284;226;58;0;59;2417
2018;2821;Arisdorf;1303;Bezirk Liestal;6;VR Alters- und Pflegeregion Liestal;6;VR Alters- und Pflegeregion Liestal;1644;14;17;-3;127;117;10;0;7;1651
2018;2822;Augst;1303;Bezirk Liestal;2;VR APG Rheintal;2;VR APG Rheintal;1020;7;11;-4;120;112;8;0;4;1024
2018;2823;Bubendorf;1303;Bezirk Liestal;6;VR Alters- und Pflegeregion Liestal;6;VR Alters- und Pflegeregion Liestal;4351;33;28;5;336;286;50;0;55;4406
2018;2824;Frenkendorf;1303;Bezirk Liestal;6;VR Alters- und Pflegeregion Liestal;6;VR Alters- und Pflegeregion Liestal;6510;55;48;7;407;448;-41;0;-34;6476
2018;2825;Füllinsdorf;1303;Bezirk Liestal;6;VR Alters- und Pflegeregion Liestal;6;VR Alters- und Pflegeregion Liestal;4483;37;53;-16;340;304;36;0;20;4503
2018;2826;Giebenach;1303;Bezirk Liestal;2;VR APG Rheintal;2;VR APG Rheintal;1036;12;4;8;109;91;18;0;26;1062
2018;2827;Hersberg;1303;Bezirk Liestal;6;VR Alters- und Pflegeregion Liestal;6;VR Alters- und Pflegeregion Liestal;308;4;4;0;32;20;12;0;12;320
2018;2828;Lausen;1303;Bezirk Liestal;6;VR Alters- und Pflegeregion Liestal;6;VR Alters- und Pflegeregion Liestal;5168;52;29;23;410;382;28;0;51;5219
2018;2829;Liestal;1303;Bezirk Liestal;6;VR Alters- und Pflegeregion Liestal;6;VR Alters- und Pflegeregion Liestal;14277;165;122;43;1190;1096;94;0;137;14414
2018;2830;Lupsingen;1303;Bezirk Liestal;6;VR Alters- und Pflegeregion Liestal;6;VR Alters- und Pflegeregion Liestal;1429;18;7;11;97;97;0;0;11;1440
2018;2831;Pratteln;1303;Bezirk Liestal;2;VR APG Rheintal;2;VR APG Rheintal;16541;179;144;35;1260;1102;158;0;193;16734
2018;2832;Ramlinsburg;1303;Bezirk Liestal;10;VR Waldenburgertal plus;8;VR Waldenburgertal plus;720;3;4;-1;44;39;5;0;4;724
2018;2833;Seltisberg;1303;Bezirk Liestal;6;VR Alters- und Pflegeregion Liestal;6;VR Alters- und Pflegeregion Liestal;1309;9;14;-5;74;70;4;0;-1;1308
2018;2834;Ziefen;1303;Bezirk Liestal;6;VR Alters- und Pflegeregion Liestal;6;VR Alters- und Pflegeregion Liestal;1580;10;9;1;123;113;10;0;11;1591
2018;2841;Anwil;1304;Bezirk Sissach;9;VR Farnsberg plus;7;Planungsregion Oberbaselbiet;576;2;3;-1;24;32;-8;0;-9;567
2018;2842;Böckten;1304;Bezirk Sissach;7;VR Oberbaselbiet;7;Planungsregion Oberbaselbiet;810;11;3;8;57;55;2;0;10;820
2018;2843;Buckten;1304;Bezirk Sissach;8;VR Oberes Homburgertal;7;Planungsregion Oberbaselbiet;697;5;12;-7;49;37;12;0;5;702
2018;2844;Buus;1304;Bezirk Sissach;9;VR Farnsberg plus;7;Planungsregion Oberbaselbiet;1046;11;7;4;77;53;24;0;28;1074
2018;2845;Diepflingen;1304;Bezirk Sissach;7;VR Oberbaselbiet;7;Planungsregion Oberbaselbiet;742;11;6;5;49;35;14;0;19;761
2018;2846;Gelterkinden;1304;Bezirk Sissach;7;VR Oberbaselbiet;7;Planungsregion Oberbaselbiet;6113;62;67;-5;455;351;104;0;99;6212
2018;2847;Häfelfingen;1304;Bezirk Sissach;8;VR Oberes Homburgertal;7;Planungsregion Oberbaselbiet;273;2;3;-1;16;36;-20;0;-21;252
2018;2848;Hemmiken;1304;Bezirk Sissach;9;VR Farnsberg plus;7;Planungsregion Oberbaselbiet;254;2;4;-2;21;8;13;0;11;265
2018;2849;Itingen;1304;Bezirk Sissach;7;VR Oberbaselbiet;7;Planungsregion Oberbaselbiet;2097;25;10;15;197;149;48;0;63;2160
2018;2850;Känerkinden;1304;Bezirk Sissach;8;VR Oberes Homburgertal;7;Planungsregion Oberbaselbiet;535;6;1;5;21;29;-8;0;-3;532
2018;2851;Kilchberg (BL);1304;Bezirk Sissach;9;VR Farnsberg plus;7;Planungsregion Oberbaselbiet;164;1;1;0;15;17;-2;0;-2;162
2018;2852;Läufelfingen;1304;Bezirk Sissach;8;VR Oberes Homburgertal;7;Planungsregion Oberbaselbiet;1322;9;14;-5;72;97;-25;0;-30;1292
2018;2853;Maisprach;1304;Bezirk Sissach;9;VR Farnsberg plus;7;Planungsregion Oberbaselbiet;946;7;5;2;78;102;-24;0;-22;924
2018;2854;Nusshof;1304;Bezirk Sissach;7;VR Oberbaselbiet;7;Planungsregion Oberbaselbiet;256;1;3;-2;24;13;11;0;9;265
2018;2855;Oltingen;1304;Bezirk Sissach;9;VR Farnsberg plus;7;Planungsregion Oberbaselbiet;471;6;1;5;36;36;0;0;5;476
2018;2856;Ormalingen;1304;Bezirk Sissach;7;VR Oberbaselbiet;7;Planungsregion Oberbaselbiet;2214;23;24;-1;198;187;11;0;10;2224
2018;2857;Rickenbach (BL);1304;Bezirk Sissach;9;VR Farnsberg plus;7;Planungsregion Oberbaselbiet;601;5;8;-3;37;37;0;0;-3;598
2018;2858;Rothenfluh;1304;Bezirk Sissach;9;VR Farnsberg plus;7;Planungsregion Oberbaselbiet;790;6;7;-1;35;58;-23;0;-24;766
2018;2859;Rümlingen;1304;Bezirk Sissach;8;VR Oberes Homburgertal;7;Planungsregion Oberbaselbiet;390;4;3;1;59;30;29;0;30;420
2018;2860;Rünenberg;1304;Bezirk Sissach;9;VR Farnsberg plus;7;Planungsregion Oberbaselbiet;782;2;13;-11;53;62;-9;0;-20;762
2018;2861;Sissach;1304;Bezirk Sissach;7;VR Oberbaselbiet;7;Planungsregion Oberbaselbiet;6687;70;47;23;478;489;-11;0;12;6699
2018;2862;Tecknau;1304;Bezirk Sissach;7;VR Oberbaselbiet;7;Planungsregion Oberbaselbiet;867;9;6;3;47;80;-33;0;-30;837
2018;2863;Tenniken;1304;Bezirk Sissach;7;VR Oberbaselbiet;7;Planungsregion Oberbaselbiet;918;9;9;0;42;52;-10;0;-10;908
2018;2864;Thürnen;1304;Bezirk Sissach;7;VR Oberbaselbiet;7;Planungsregion Oberbaselbiet;1402;14;11;3;95;133;-38;0;-35;1367
2018;2865;Wenslingen;1304;Bezirk Sissach;7;VR Oberbaselbiet;7;Planungsregion Oberbaselbiet;728;5;2;3;35;42;-7;0;-4;724
2018;2866;Wintersingen;1304;Bezirk Sissach;9;VR Farnsberg plus;7;Planungsregion Oberbaselbiet;607;6;4;2;41;29;12;0;14;621
2018;2867;Wittinsburg;1304;Bezirk Sissach;7;VR Oberbaselbiet;7;Planungsregion Oberbaselbiet;434;0;4;-4;25;31;-6;0;-10;424
2018;2868;Zeglingen;1304;Bezirk Sissach;9;VR Farnsberg plus;7;Planungsregion Oberbaselbiet;491;3;3;0;33;16;17;0;17;508
2018;2869;Zunzgen;1304;Bezirk Sissach;7;VR Oberbaselbiet;7;Planungsregion Oberbaselbiet;2510;17;22;-5;204;139;65;0;60;2570
2018;2881;Arboldswil;1305;Bezirk Waldenburg;10;VR Waldenburgertal plus;8;VR Waldenburgertal plus;567;3;1;2;45;33;12;0;14;581
2018;2882;Bennwil;1305;Bezirk Waldenburg;10;VR Waldenburgertal plus;8;VR Waldenburgertal plus;670;7;5;2;36;42;-6;0;-4;666
2018;2883;Bretzwil;1305;Bezirk Waldenburg;10;VR Waldenburgertal plus;8;VR Waldenburgertal plus;783;6;5;1;31;46;-15;0;-14;769
2018;2884;Diegten;1305;Bezirk Waldenburg;7;VR Oberbaselbiet;7;Planungsregion Oberbaselbiet;1664;6;8;-2;122;123;-1;0;-3;1661
2018;2885;Eptingen;1305;Bezirk Waldenburg;7;VR Oberbaselbiet;7;Planungsregion Oberbaselbiet;538;5;4;1;51;51;0;0;1;539
2018;2886;Hölstein;1305;Bezirk Waldenburg;10;VR Waldenburgertal plus;8;VR Waldenburgertal plus;2504;24;14;10;230;210;20;0;30;2534
2018;2887;Lampenberg;1305;Bezirk Waldenburg;10;VR Waldenburgertal plus;8;VR Waldenburgertal plus;506;1;2;-1;15;18;-3;0;-4;502
2018;2888;Langenbruck;1305;Bezirk Waldenburg;10;VR Waldenburgertal plus;8;VR Waldenburgertal plus;981;6;5;1;127;120;7;0;8;989
2018;2889;Lauwil;1305;Bezirk Waldenburg;10;VR Waldenburgertal plus;8;VR Waldenburgertal plus;322;2;4;-2;26;19;7;0;5;327
2018;2890;Liedertswil;1305;Bezirk Waldenburg;10;VR Waldenburgertal plus;8;VR Waldenburgertal plus;165;1;1;0;4;12;-8;0;-8;157
2018;2891;Niederdorf;1305;Bezirk Waldenburg;10;VR Waldenburgertal plus;8;VR Waldenburgertal plus;1813;15;17;-2;150;160;-10;0;-12;1801
2018;2892;Oberdorf (BL);1305;Bezirk Waldenburg;10;VR Waldenburgertal plus;8;VR Waldenburgertal plus;2427;20;24;-4;196;176;20;0;16;2443
2018;2893;Reigoldswil;1305;Bezirk Waldenburg;10;VR Waldenburgertal plus;8;VR Waldenburgertal plus;1620;12;10;2;109;142;-33;0;-31;1589
2018;2894;Titterten;1305;Bezirk Waldenburg;10;VR Waldenburgertal plus;8;VR Waldenburgertal plus;414;3;2;1;24;35;-11;0;-10;404
2018;2895;Waldenburg;1305;Bezirk Waldenburg;10;VR Waldenburgertal plus;8;VR Waldenburgertal plus;1144;11;11;0;102;160;-58;0;-58;1086
2019;2761;Aesch (BL);1301;Bezirk Arlesheim;3;VR Alter Birsstadt;3;VR Alter Birsstadt;10406;68;83;-15;847;802;45;0;30;10436
2019;2762;Allschwil;1301;Bezirk Arlesheim;1;VR Alter und Gesundheit ABS;1;VR Alter und Gesundheit ABS;21242;240;224;16;1345;1429;-84;0;-68;21174
2019;2763;Arlesheim;1301;Bezirk Arlesheim;3;VR Alter Birsstadt;3;VR Alter Birsstadt;9159;76;94;-18;556;526;30;0;12;9171
2019;2764;Biel-Benken;1301;Bezirk Arlesheim;4;VR BPA Leimental;4;VR BPA Leimental;3446;19;18;1;236;173;63;0;64;3510
2019;2765;Binningen;1301;Bezirk Arlesheim;1;VR Alter und Gesundheit ABS;1;VR Alter und Gesundheit ABS;15754;142;156;-14;1220;1090;130;0;116;15870
2019;2766;Birsfelden;1301;Bezirk Arlesheim;2;VR APG Rheintal;2;VR APG Rheintal;10350;101;110;-9;868;723;145;0;136;10486
2019;2767;Bottmingen;1301;Bezirk Arlesheim;4;VR BPA Leimental;4;VR BPA Leimental;6737;44;50;-6;657;570;87;0;81;6818
2019;2768;Ettingen;1301;Bezirk Arlesheim;4;VR BPA Leimental;4;VR BPA Leimental;5290;53;38;15;426;364;62;0;77;5367
2019;2769;Münchenstein;1301;Bezirk Arlesheim;3;VR Alter Birsstadt;3;VR Alter Birsstadt;12161;115;112;3;878;877;1;0;4;12165
2019;2770;Muttenz;1301;Bezirk Arlesheim;2;VR APG Rheintal;2;VR APG Rheintal;17880;161;185;-24;1066;951;115;0;91;17971
2019;2771;Oberwil (BL);1301;Bezirk Arlesheim;4;VR BPA Leimental;4;VR BPA Leimental;11193;111;92;19;778;718;60;0;79;11272
2019;2772;Pfeffingen;1301;Bezirk Arlesheim;3;VR Alter Birsstadt;3;VR Alter Birsstadt;2348;14;17;-3;159;126;33;0;30;2378
2019;2773;Reinach (BL);1301;Bezirk Arlesheim;3;VR Alter Birsstadt;3;VR Alter Birsstadt;19267;126;186;-60;1181;1139;42;0;-18;19249
2019;2774;Schönenbuch;1301;Bezirk Arlesheim;1;VR Alter und Gesundheit ABS;1;VR Alter und Gesundheit ABS;1407;11;13;-2;98;92;6;0;4;1411
2019;2775;Therwil;1301;Bezirk Arlesheim;4;VR BPA Leimental;4;VR BPA Leimental;9896;79;65;14;646;613;33;0;47;9943
2019;2781;Blauen;1302;Bezirk Laufen;5;VR APG Laufental;5;VR APG Laufental;693;7;1;6;35;33;2;0;8;701
2019;2782;Brislach;1302;Bezirk Laufen;5;VR APG Laufental;5;VR APG Laufental;1659;13;15;-2;100;92;8;0;6;1665
2019;2783;Burg im Leimental;1302;Bezirk Laufen;4;VR BPA Leimental;4;VR BPA Leimental;265;4;0;4;21;12;9;0;13;278
2019;2784;Dittingen;1302;Bezirk Laufen;5;VR APG Laufental;5;VR APG Laufental;731;0;5;-5;57;73;-16;0;-21;710
2019;2785;Duggingen;1302;Bezirk Laufen;3;VR Alter Birsstadt;3;VR Alter Birsstadt;1550;11;9;2;128;129;-1;0;1;1551
2019;2786;Grellingen;1302;Bezirk Laufen;5;VR APG Laufental;5;VR APG Laufental;1849;22;14;8;157;141;16;0;24;1873
2019;2787;Laufen;1302;Bezirk Laufen;5;VR APG Laufental;5;VR APG Laufental;5642;42;46;-4;441;418;23;0;19;5661
2019;2788;Liesberg;1302;Bezirk Laufen;5;VR APG Laufental;5;VR APG Laufental;1137;5;9;-4;64;90;-26;0;-30;1107
2019;2789;Nenzlingen;1302;Bezirk Laufen;5;VR APG Laufental;5;VR APG Laufental;445;4;2;2;29;19;10;0;12;457
2019;2790;Roggenburg;1302;Bezirk Laufen;5;VR APG Laufental;5;VR APG Laufental;280;0;3;-3;14;11;3;0;0;280
2019;2791;Röschenz;1302;Bezirk Laufen;5;VR APG Laufental;5;VR APG Laufental;1873;14;10;4;120;96;24;0;28;1901
2019;2792;Wahlen;1302;Bezirk Laufen;5;VR APG Laufental;5;VR APG Laufental;1463;10;10;0;97;94;3;0;3;1466
2019;2793;Zwingen;1302;Bezirk Laufen;5;VR APG Laufental;5;VR APG Laufental;2417;28;5;23;219;189;30;0;53;2470
2019;2821;Arisdorf;1303;Bezirk Liestal;6;VR Alters- und Pflegeregion Liestal;6;VR Alters- und Pflegeregion Liestal;1651;9;8;1;115;105;10;0;11;1662
2019;2822;Augst;1303;Bezirk Liestal;2;VR APG Rheintal;2;VR APG Rheintal;1024;10;12;-2;134;106;28;0;26;1050
2019;2823;Bubendorf;1303;Bezirk Liestal;6;VR Alters- und Pflegeregion Liestal;6;VR Alters- und Pflegeregion Liestal;4406;41;32;9;299;299;0;0;9;4415
2019;2824;Frenkendorf;1303;Bezirk Liestal;6;VR Alters- und Pflegeregion Liestal;6;VR Alters- und Pflegeregion Liestal;6476;55;53;2;458;452;6;0;8;6484
2019;2825;Füllinsdorf;1303;Bezirk Liestal;6;VR Alters- und Pflegeregion Liestal;6;VR Alters- und Pflegeregion Liestal;4503;36;55;-19;414;296;118;0;99;4602
2019;2826;Giebenach;1303;Bezirk Liestal;2;VR APG Rheintal;2;VR APG Rheintal;1062;7;2;5;101;117;-16;0;-11;1051
2019;2827;Hersberg;1303;Bezirk Liestal;6;VR Alters- und Pflegeregion Liestal;6;VR Alters- und Pflegeregion Liestal;320;3;2;1;21;11;10;0;11;331
2019;2828;Lausen;1303;Bezirk Liestal;6;VR Alters- und Pflegeregion Liestal;6;VR Alters- und Pflegeregion Liestal;5219;52;37;15;426;333;93;0;108;5327
2019;2829;Liestal;1303;Bezirk Liestal;6;VR Alters- und Pflegeregion Liestal;6;VR Alters- und Pflegeregion Liestal;14414;117;125;-8;1194;1190;4;0;-4;14410
2019;2830;Lupsingen;1303;Bezirk Liestal;6;VR Alters- und Pflegeregion Liestal;6;VR Alters- und Pflegeregion Liestal;1440;15;9;6;95;90;5;0;11;1451
2019;2831;Pratteln;1303;Bezirk Liestal;2;VR APG Rheintal;2;VR APG Rheintal;16734;180;140;40;1119;1158;-39;0;1;16735
2019;2832;Ramlinsburg;1303;Bezirk Liestal;10;VR Waldenburgertal plus;8;VR Waldenburgertal plus;724;5;5;0;57;73;-16;0;-16;708
2019;2833;Seltisberg;1303;Bezirk Liestal;6;VR Alters- und Pflegeregion Liestal;6;VR Alters- und Pflegeregion Liestal;1308;6;5;1;55;70;-15;0;-14;1294
2019;2834;Ziefen;1303;Bezirk Liestal;6;VR Alters- und Pflegeregion Liestal;6;VR Alters- und Pflegeregion Liestal;1591;14;5;9;75;106;-31;0;-22;1569
2019;2841;Anwil;1304;Bezirk Sissach;9;VR Farnsberg plus;7;Planungsregion Oberbaselbiet;567;7;3;4;19;37;-18;0;-14;553
2019;2842;Böckten;1304;Bezirk Sissach;7;VR Oberbaselbiet;7;Planungsregion Oberbaselbiet;820;8;7;1;59;56;3;0;4;824
2019;2843;Buckten;1304;Bezirk Sissach;8;VR Oberes Homburgertal;7;Planungsregion Oberbaselbiet;702;8;12;-4;53;57;-4;0;-8;694
2019;2844;Buus;1304;Bezirk Sissach;9;VR Farnsberg plus;7;Planungsregion Oberbaselbiet;1074;8;8;0;64;57;7;0;7;1081
2019;2845;Diepflingen;1304;Bezirk Sissach;7;VR Oberbaselbiet;7;Planungsregion Oberbaselbiet;761;9;1;8;55;43;12;0;20;781
2019;2846;Gelterkinden;1304;Bezirk Sissach;7;VR Oberbaselbiet;7;Planungsregion Oberbaselbiet;6212;67;65;2;477;404;73;-1;74;6286
2019;2847;Häfelfingen;1304;Bezirk Sissach;8;VR Oberes Homburgertal;7;Planungsregion Oberbaselbiet;252;1;3;-2;19;24;-5;0;-7;245
2019;2848;Hemmiken;1304;Bezirk Sissach;9;VR Farnsberg plus;7;Planungsregion Oberbaselbiet;265;4;6;-2;17;21;-4;0;-6;259
2019;2849;Itingen;1304;Bezirk Sissach;7;VR Oberbaselbiet;7;Planungsregion Oberbaselbiet;2160;16;13;3;143;145;-2;0;1;2161
2019;2850;Känerkinden;1304;Bezirk Sissach;8;VR Oberes Homburgertal;7;Planungsregion Oberbaselbiet;532;5;3;2;35;35;0;0;2;534
2019;2851;Kilchberg (BL);1304;Bezirk Sissach;9;VR Farnsberg plus;7;Planungsregion Oberbaselbiet;162;1;1;0;23;22;1;0;1;163
2019;2852;Läufelfingen;1304;Bezirk Sissach;8;VR Oberes Homburgertal;7;Planungsregion Oberbaselbiet;1292;5;4;1;78;80;-2;0;-1;1291
2019;2853;Maisprach;1304;Bezirk Sissach;9;VR Farnsberg plus;7;Planungsregion Oberbaselbiet;924;11;11;0;84;74;10;0;10;934
2019;2854;Nusshof;1304;Bezirk Sissach;7;VR Oberbaselbiet;7;Planungsregion Oberbaselbiet;265;0;0;0;7;10;-3;0;-3;262
2019;2855;Oltingen;1304;Bezirk Sissach;9;VR Farnsberg plus;7;Planungsregion Oberbaselbiet;476;7;3;4;36;17;19;0;23;499
2019;2856;Ormalingen;1304;Bezirk Sissach;7;VR Oberbaselbiet;7;Planungsregion Oberbaselbiet;2224;27;14;13;182;146;36;0;49;2273
2019;2857;Rickenbach (BL);1304;Bezirk Sissach;9;VR Farnsberg plus;7;Planungsregion Oberbaselbiet;598;3;1;2;32;47;-15;0;-13;585
2019;2858;Rothenfluh;1304;Bezirk Sissach;9;VR Farnsberg plus;7;Planungsregion Oberbaselbiet;766;4;11;-7;45;39;6;0;-1;765
2019;2859;Rümlingen;1304;Bezirk Sissach;8;VR Oberes Homburgertal;7;Planungsregion Oberbaselbiet;420;5;5;0;39;24;15;0;15;435
2019;2860;Rünenberg;1304;Bezirk Sissach;9;VR Farnsberg plus;7;Planungsregion Oberbaselbiet;762;4;7;-3;38;49;-11;0;-14;748
2019;2861;Sissach;1304;Bezirk Sissach;7;VR Oberbaselbiet;7;Planungsregion Oberbaselbiet;6699;62;52;10;484;494;-10;-1;-1;6698
2019;2862;Tecknau;1304;Bezirk Sissach;7;VR Oberbaselbiet;7;Planungsregion Oberbaselbiet;837;6;2;4;83;80;3;0;7;844
2019;2863;Tenniken;1304;Bezirk Sissach;7;VR Oberbaselbiet;7;Planungsregion Oberbaselbiet;908;5;4;1;65;56;9;0;10;918
2019;2864;Thürnen;1304;Bezirk Sissach;7;VR Oberbaselbiet;7;Planungsregion Oberbaselbiet;1367;9;16;-7;108;104;4;0;-3;1364
2019;2865;Wenslingen;1304;Bezirk Sissach;7;VR Oberbaselbiet;7;Planungsregion Oberbaselbiet;724;6;10;-4;34;44;-10;0;-14;710
2019;2866;Wintersingen;1304;Bezirk Sissach;9;VR Farnsberg plus;7;Planungsregion Oberbaselbiet;621;2;8;-6;58;65;-7;0;-13;608
2019;2867;Wittinsburg;1304;Bezirk Sissach;7;VR Oberbaselbiet;7;Planungsregion Oberbaselbiet;424;7;4;3;24;12;12;0;15;439
2019;2868;Zeglingen;1304;Bezirk Sissach;9;VR Farnsberg plus;7;Planungsregion Oberbaselbiet;508;11;5;6;18;39;-21;0;-15;493
2019;2869;Zunzgen;1304;Bezirk Sissach;7;VR Oberbaselbiet;7;Planungsregion Oberbaselbiet;2570;28;30;-2;228;174;54;0;52;2622
2019;2881;Arboldswil;1305;Bezirk Waldenburg;10;VR Waldenburgertal plus;8;VR Waldenburgertal plus;581;7;3;4;30;31;-1;0;3;584
2019;2882;Bennwil;1305;Bezirk Waldenburg;10;VR Waldenburgertal plus;8;VR Waldenburgertal plus;666;9;4;5;52;53;-1;0;4;670
2019;2883;Bretzwil;1305;Bezirk Waldenburg;10;VR Waldenburgertal plus;8;VR Waldenburgertal plus;769;7;6;1;35;52;-17;0;-16;753
2019;2884;Diegten;1305;Bezirk Waldenburg;7;VR Oberbaselbiet;7;Planungsregion Oberbaselbiet;1661;14;14;0;87;119;-32;0;-32;1629
2019;2885;Eptingen;1305;Bezirk Waldenburg;7;VR Oberbaselbiet;7;Planungsregion Oberbaselbiet;539;6;2;4;44;45;-1;0;3;542
2019;2886;Hölstein;1305;Bezirk Waldenburg;10;VR Waldenburgertal plus;8;VR Waldenburgertal plus;2534;17;21;-4;210;168;42;0;38;2572
2019;2887;Lampenberg;1305;Bezirk Waldenburg;10;VR Waldenburgertal plus;8;VR Waldenburgertal plus;502;4;4;0;31;22;9;0;9;511
2019;2888;Langenbruck;1305;Bezirk Waldenburg;10;VR Waldenburgertal plus;8;VR Waldenburgertal plus;989;6;8;-2;80;98;-18;0;-20;969
2019;2889;Lauwil;1305;Bezirk Waldenburg;10;VR Waldenburgertal plus;8;VR Waldenburgertal plus;327;3;6;-3;14;20;-6;0;-9;318
2019;2890;Liedertswil;1305;Bezirk Waldenburg;10;VR Waldenburgertal plus;8;VR Waldenburgertal plus;157;0;3;-3;6;4;2;0;-1;156
2019;2891;Niederdorf;1305;Bezirk Waldenburg;10;VR Waldenburgertal plus;8;VR Waldenburgertal plus;1801;16;10;6;194;137;57;0;63;1864
2019;2892;Oberdorf (BL);1305;Bezirk Waldenburg;10;VR Waldenburgertal plus;8;VR Waldenburgertal plus;2443;17;20;-3;183;184;-1;0;-4;2439
2019;2893;Reigoldswil;1305;Bezirk Waldenburg;10;VR Waldenburgertal plus;8;VR Waldenburgertal plus;1589;18;11;7;115;122;-7;-1;-1;1588
2019;2894;Titterten;1305;Bezirk Waldenburg;10;VR Waldenburgertal plus;8;VR Waldenburgertal plus;404;2;5;-3;32;13;19;0;16;420
2019;2895;Waldenburg;1305;Bezirk Waldenburg;10;VR Waldenburgertal plus;8;VR Waldenburgertal plus;1086;11;9;2;128;97;31;0;33;1119
2020;2761;Aesch (BL);1301;Bezirk Arlesheim;3;VR Alter Birsstadt;3;VR Alter Birsstadt;10436;83;108;-25;745;804;-59;0;-84;10352
2020;2762;Allschwil;1301;Bezirk Arlesheim;1;VR Alter und Gesundheit ABS;1;VR Alter und Gesundheit ABS;21174;229;201;28;1515;1305;210;0;238;21412
2020;2763;Arlesheim;1301;Bezirk Arlesheim;3;VR Alter Birsstadt;3;VR Alter Birsstadt;9171;69;113;-44;639;527;112;0;68;9239
2020;2764;Biel-Benken;1301;Bezirk Arlesheim;4;VR BPA Leimental;4;VR BPA Leimental;3510;26;28;-2;268;193;75;0;73;3583
2020;2765;Binningen;1301;Bezirk Arlesheim;1;VR Alter und Gesundheit ABS;1;VR Alter und Gesundheit ABS;15870;153;152;1;1145;1170;-25;0;-24;15846
2020;2766;Birsfelden;1301;Bezirk Arlesheim;2;VR APG Rheintal;2;VR APG Rheintal;10486;86;147;-61;821;803;18;0;-43;10443
2020;2767;Bottmingen;1301;Bezirk Arlesheim;4;VR BPA Leimental;4;VR BPA Leimental;6818;69;63;6;640;541;99;0;105;6923
2020;2768;Ettingen;1301;Bezirk Arlesheim;4;VR BPA Leimental;4;VR BPA Leimental;5367;54;50;4;451;361;90;0;94;5461
2020;2769;Münchenstein;1301;Bezirk Arlesheim;3;VR Alter Birsstadt;3;VR Alter Birsstadt;12165;104;142;-38;949;953;-4;0;-42;12123
2020;2770;Muttenz;1301;Bezirk Arlesheim;2;VR APG Rheintal;2;VR APG Rheintal;17971;156;213;-57;1081;997;84;-2;25;17996
2020;2771;Oberwil (BL);1301;Bezirk Arlesheim;4;VR BPA Leimental;4;VR BPA Leimental;11272;82;108;-26;736;838;-102;0;-128;11144
2020;2772;Pfeffingen;1301;Bezirk Arlesheim;3;VR Alter Birsstadt;3;VR Alter Birsstadt;2378;17;19;-2;185;139;46;0;44;2422
2020;2773;Reinach (BL);1301;Bezirk Arlesheim;3;VR Alter Birsstadt;3;VR Alter Birsstadt;19249;122;211;-89;1180;1093;87;1;-1;19248
2020;2774;Schönenbuch;1301;Bezirk Arlesheim;1;VR Alter und Gesundheit ABS;1;VR Alter und Gesundheit ABS;1411;12;8;4;89;63;26;0;30;1441
2020;2775;Therwil;1301;Bezirk Arlesheim;4;VR BPA Leimental;4;VR BPA Leimental;9943;73;93;-20;716;620;96;0;76;10019
2020;2781;Blauen;1302;Bezirk Laufen;5;VR APG Laufental;5;VR APG Laufental;701;1;5;-4;27;34;-7;0;-11;690
2020;2782;Brislach;1302;Bezirk Laufen;5;VR APG Laufental;5;VR APG Laufental;1665;12;10;2;120;92;28;0;30;1695
2020;2783;Burg im Leimental;1302;Bezirk Laufen;4;VR BPA Leimental;4;VR BPA Leimental;278;1;4;-3;22;16;6;0;3;281
2020;2784;Dittingen;1302;Bezirk Laufen;5;VR APG Laufental;5;VR APG Laufental;710;4;6;-2;87;51;36;0;34;744
2020;2785;Duggingen;1302;Bezirk Laufen;3;VR Alter Birsstadt;3;VR Alter Birsstadt;1551;6;9;-3;128;121;7;0;4;1555
2020;2786;Grellingen;1302;Bezirk Laufen;5;VR APG Laufental;5;VR APG Laufental;1873;18;15;3;142;156;-14;0;-11;1862
2020;2787;Laufen;1302;Bezirk Laufen;5;VR APG Laufental;5;VR APG Laufental;5661;45;49;-4;529;393;136;0;132;5793
2020;2788;Liesberg;1302;Bezirk Laufen;5;VR APG Laufental;5;VR APG Laufental;1107;6;9;-3;107;99;8;0;5;1112
2020;2789;Nenzlingen;1302;Bezirk Laufen;5;VR APG Laufental;5;VR APG Laufental;457;2;3;-1;34;43;-9;0;-10;447
2020;2790;Roggenburg;1302;Bezirk Laufen;5;VR APG Laufental;5;VR APG Laufental;280;0;1;-1;18;27;-9;0;-10;270
2020;2791;Röschenz;1302;Bezirk Laufen;5;VR APG Laufental;5;VR APG Laufental;1901;19;21;-2;117;112;5;0;3;1904
2020;2792;Wahlen;1302;Bezirk Laufen;5;VR APG Laufental;5;VR APG Laufental;1466;11;15;-4;142;101;41;0;37;1503
2020;2793;Zwingen;1302;Bezirk Laufen;5;VR APG Laufental;5;VR APG Laufental;2470;12;22;-10;290;230;60;0;50;2520
2020;2821;Arisdorf;1303;Bezirk Liestal;6;VR Alters- und Pflegeregion Liestal;6;VR Alters- und Pflegeregion Liestal;1662;17;13;4;136;103;33;0;37;1699
2020;2822;Augst;1303;Bezirk Liestal;2;VR APG Rheintal;2;VR APG Rheintal;1050;12;13;-1;140;117;23;0;22;1072
2020;2823;Bubendorf;1303;Bezirk Liestal;6;VR Alters- und Pflegeregion Liestal;6;VR Alters- und Pflegeregion Liestal;4415;45;30;15;281;348;-67;0;-52;4363
2020;2824;Frenkendorf;1303;Bezirk Liestal;6;VR Alters- und Pflegeregion Liestal;6;VR Alters- und Pflegeregion Liestal;6484;65;44;21;462;450;12;0;33;6517
2020;2825;Füllinsdorf;1303;Bezirk Liestal;6;VR Alters- und Pflegeregion Liestal;6;VR Alters- und Pflegeregion Liestal;4602;52;58;-6;366;371;-5;0;-11;4591
2020;2826;Giebenach;1303;Bezirk Liestal;2;VR APG Rheintal;2;VR APG Rheintal;1051;7;7;0;106;67;39;0;39;1090
2020;2827;Hersberg;1303;Bezirk Liestal;6;VR Alters- und Pflegeregion Liestal;6;VR Alters- und Pflegeregion Liestal;331;3;2;1;33;15;18;0;19;350
2020;2828;Lausen;1303;Bezirk Liestal;6;VR Alters- und Pflegeregion Liestal;6;VR Alters- und Pflegeregion Liestal;5327;41;30;11;552;417;135;-1;145;5472
2020;2829;Liestal;1303;Bezirk Liestal;6;VR Alters- und Pflegeregion Liestal;6;VR Alters- und Pflegeregion Liestal;14410;138;148;-10;1430;1031;399;-1;388;14798
2020;2830;Lupsingen;1303;Bezirk Liestal;6;VR Alters- und Pflegeregion Liestal;6;VR Alters- und Pflegeregion Liestal;1451;6;14;-8;103;95;8;0;0;1451
2020;2831;Pratteln;1303;Bezirk Liestal;2;VR APG Rheintal;2;VR APG Rheintal;16735;193;148;45;1091;1185;-94;0;-49;16686
2020;2832;Ramlinsburg;1303;Bezirk Liestal;10;VR Waldenburgertal plus;8;VR Waldenburgertal plus;708;7;2;5;51;43;8;0;13;721
2020;2833;Seltisberg;1303;Bezirk Liestal;6;VR Alters- und Pflegeregion Liestal;6;VR Alters- und Pflegeregion Liestal;1294;11;16;-5;95;73;22;0;17;1311
2020;2834;Ziefen;1303;Bezirk Liestal;6;VR Alters- und Pflegeregion Liestal;6;VR Alters- und Pflegeregion Liestal;1569;13;8;5;152;80;72;0;77;1646
2020;2841;Anwil;1304;Bezirk Sissach;9;VR Farnsberg plus;7;Planungsregion Oberbaselbiet;553;2;2;0;22;33;-11;0;-11;542
2020;2842;Böckten;1304;Bezirk Sissach;7;VR Oberbaselbiet;7;Planungsregion Oberbaselbiet;824;9;7;2;60;61;-1;0;1;825
2020;2843;Buckten;1304;Bezirk Sissach;8;VR Oberes Homburgertal;7;Planungsregion Oberbaselbiet;694;2;6;-4;69;55;14;0;10;704
2020;2844;Buus;1304;Bezirk Sissach;9;VR Farnsberg plus;7;Planungsregion Oberbaselbiet;1081;9;7;2;82;71;11;0;13;1094
2020;2845;Diepflingen;1304;Bezirk Sissach;7;VR Oberbaselbiet;7;Planungsregion Oberbaselbiet;781;13;6;7;34;64;-30;0;-23;758
2020;2846;Gelterkinden;1304;Bezirk Sissach;7;VR Oberbaselbiet;7;Planungsregion Oberbaselbiet;6286;54;57;-3;397;455;-58;0;-61;6225
2020;2847;Häfelfingen;1304;Bezirk Sissach;8;VR Oberes Homburgertal;7;Planungsregion Oberbaselbiet;245;2;0;2;31;24;7;0;9;254
2020;2848;Hemmiken;1304;Bezirk Sissach;9;VR Farnsberg plus;7;Planungsregion Oberbaselbiet;259;2;3;-1;25;20;5;0;4;263
2020;2849;Itingen;1304;Bezirk Sissach;7;VR Oberbaselbiet;7;Planungsregion Oberbaselbiet;2161;17;11;6;165;142;23;0;29;2190
2020;2850;Känerkinden;1304;Bezirk Sissach;8;VR Oberes Homburgertal;7;Planungsregion Oberbaselbiet;534;1;3;-2;35;32;3;0;1;535
2020;2851;Kilchberg (BL);1304;Bezirk Sissach;9;VR Farnsberg plus;7;Planungsregion Oberbaselbiet;163;1;1;0;28;20;8;0;8;171
2020;2852;Läufelfingen;1304;Bezirk Sissach;8;VR Oberes Homburgertal;7;Planungsregion Oberbaselbiet;1291;7;12;-5;98;113;-15;0;-20;1271
2020;2853;Maisprach;1304;Bezirk Sissach;9;VR Farnsberg plus;7;Planungsregion Oberbaselbiet;934;8;7;1;78;78;0;0;1;935
2020;2854;Nusshof;1304;Bezirk Sissach;7;VR Oberbaselbiet;7;Planungsregion Oberbaselbiet;262;0;2;-2;11;11;0;0;-2;260
2020;2855;Oltingen;1304;Bezirk Sissach;9;VR Farnsberg plus;7;Planungsregion Oberbaselbiet;499;6;3;3;34;27;7;0;10;509
2020;2856;Ormalingen;1304;Bezirk Sissach;7;VR Oberbaselbiet;7;Planungsregion Oberbaselbiet;2273;27;30;-3;195;180;15;0;12;2285
2020;2857;Rickenbach (BL);1304;Bezirk Sissach;9;VR Farnsberg plus;7;Planungsregion Oberbaselbiet;585;8;3;5;46;26;20;0;25;610
2020;2858;Rothenfluh;1304;Bezirk Sissach;9;VR Farnsberg plus;7;Planungsregion Oberbaselbiet;765;12;6;6;55;43;12;0;18;783
2020;2859;Rümlingen;1304;Bezirk Sissach;8;VR Oberes Homburgertal;7;Planungsregion Oberbaselbiet;435;6;4;2;36;39;-3;0;-1;434
2020;2860;Rünenberg;1304;Bezirk Sissach;9;VR Farnsberg plus;7;Planungsregion Oberbaselbiet;748;3;4;-1;59;44;15;0;14;762
2020;2861;Sissach;1304;Bezirk Sissach;7;VR Oberbaselbiet;7;Planungsregion Oberbaselbiet;6698;76;55;21;475;481;-6;0;15;6713
2020;2862;Tecknau;1304;Bezirk Sissach;7;VR Oberbaselbiet;7;Planungsregion Oberbaselbiet;844;9;9;0;73;83;-10;0;-10;834
2020;2863;Tenniken;1304;Bezirk Sissach;7;VR Oberbaselbiet;7;Planungsregion Oberbaselbiet;918;6;3;3;77;69;8;0;11;929
2020;2864;Thürnen;1304;Bezirk Sissach;7;VR Oberbaselbiet;7;Planungsregion Oberbaselbiet;1364;14;17;-3;130;110;20;0;17;1381
2020;2865;Wenslingen;1304;Bezirk Sissach;7;VR Oberbaselbiet;7;Planungsregion Oberbaselbiet;710;5;4;1;32;46;-14;0;-13;697
2020;2866;Wintersingen;1304;Bezirk Sissach;9;VR Farnsberg plus;7;Planungsregion Oberbaselbiet;608;6;5;1;56;26;30;0;31;639
2020;2867;Wittinsburg;1304;Bezirk Sissach;7;VR Oberbaselbiet;7;Planungsregion Oberbaselbiet;439;2;2;0;10;19;-9;0;-9;430
2020;2868;Zeglingen;1304;Bezirk Sissach;9;VR Farnsberg plus;7;Planungsregion Oberbaselbiet;493;0;2;-2;30;26;4;0;2;495
2020;2869;Zunzgen;1304;Bezirk Sissach;7;VR Oberbaselbiet;7;Planungsregion Oberbaselbiet;2622;14;26;-12;195;168;27;0;15;2637
2020;2881;Arboldswil;1305;Bezirk Waldenburg;10;VR Waldenburgertal plus;8;VR Waldenburgertal plus;584;4;5;-1;22;41;-19;0;-20;564
2020;2882;Bennwil;1305;Bezirk Waldenburg;10;VR Waldenburgertal plus;8;VR Waldenburgertal plus;670;6;3;3;45;39;6;0;9;679
2020;2883;Bretzwil;1305;Bezirk Waldenburg;10;VR Waldenburgertal plus;8;VR Waldenburgertal plus;753;5;7;-2;32;40;-8;0;-10;743
2020;2884;Diegten;1305;Bezirk Waldenburg;7;VR Oberbaselbiet;7;Planungsregion Oberbaselbiet;1629;16;16;0;123;128;-5;0;-5;1624
2020;2885;Eptingen;1305;Bezirk Waldenburg;7;VR Oberbaselbiet;7;Planungsregion Oberbaselbiet;542;6;6;0;48;48;0;0;0;542
2020;2886;Hölstein;1305;Bezirk Waldenburg;10;VR Waldenburgertal plus;8;VR Waldenburgertal plus;2572;17;20;-3;196;182;14;0;11;2583
2020;2887;Lampenberg;1305;Bezirk Waldenburg;10;VR Waldenburgertal plus;8;VR Waldenburgertal plus;511;4;5;-1;35;23;12;0;11;522
2020;2888;Langenbruck;1305;Bezirk Waldenburg;10;VR Waldenburgertal plus;8;VR Waldenburgertal plus;969;3;8;-5;88;89;-1;0;-6;963
2020;2889;Lauwil;1305;Bezirk Waldenburg;10;VR Waldenburgertal plus;8;VR Waldenburgertal plus;318;0;5;-5;19;22;-3;0;-8;310
2020;2890;Liedertswil;1305;Bezirk Waldenburg;10;VR Waldenburgertal plus;8;VR Waldenburgertal plus;156;2;2;0;6;6;0;0;0;156
2020;2891;Niederdorf;1305;Bezirk Waldenburg;10;VR Waldenburgertal plus;8;VR Waldenburgertal plus;1864;15;15;0;131;158;-27;0;-27;1837
2020;2892;Oberdorf (BL);1305;Bezirk Waldenburg;10;VR Waldenburgertal plus;8;VR Waldenburgertal plus;2439;21;30;-9;204;182;22;0;13;2452
2020;2893;Reigoldswil;1305;Bezirk Waldenburg;10;VR Waldenburgertal plus;8;VR Waldenburgertal plus;1588;17;9;8;113;117;-4;0;4;1592
2020;2894;Titterten;1305;Bezirk Waldenburg;10;VR Waldenburgertal plus;8;VR Waldenburgertal plus;420;3;2;1;29;28;1;0;2;422
2020;2895;Waldenburg;1305;Bezirk Waldenburg;10;VR Waldenburgertal plus;8;VR Waldenburgertal plus;1119;11;8;3;119;110;9;0;12;1131
2021;2761;Aesch (BL);1301;Bezirk Arlesheim;3;VR Alter Birsstadt;3;VR Alter Birsstadt;10352;108;99;9;987;754;233;0;242;10594
2021;2762;Allschwil;1301;Bezirk Arlesheim;1;VR Alter und Gesundheit ABS;1;VR Alter und Gesundheit ABS;21412;211;227;-16;1587;1312;275;0;259;21671
2021;2763;Arlesheim;1301;Bezirk Arlesheim;3;VR Alter Birsstadt;3;VR Alter Birsstadt;9239;59;124;-65;572;498;74;0;9;9248
2021;2764;Biel-Benken;1301;Bezirk Arlesheim;4;VR BPA Leimental;4;VR BPA Leimental;3583;26;20;6;226;209;17;0;23;3606
2021;2765;Binningen;1301;Bezirk Arlesheim;1;VR Alter und Gesundheit ABS;1;VR Alter und Gesundheit ABS;15846;137;159;-22;1060;1195;-135;0;-157;15689
2021;2766;Birsfelden;1301;Bezirk Arlesheim;2;VR APG Rheintal;2;VR APG Rheintal;10443;100;120;-20;796;819;-23;0;-43;10400
2021;2767;Bottmingen;1301;Bezirk Arlesheim;4;VR BPA Leimental;4;VR BPA Leimental;6923;66;48;18;609;574;35;0;53;6976
2021;2768;Ettingen;1301;Bezirk Arlesheim;4;VR BPA Leimental;4;VR BPA Leimental;5461;55;42;13;435;348;87;0;100;5561
2021;2769;Münchenstein;1301;Bezirk Arlesheim;3;VR Alter Birsstadt;3;VR Alter Birsstadt;12123;124;109;15;968;988;-20;0;-5;12118
2021;2770;Muttenz;1301;Bezirk Arlesheim;2;VR APG Rheintal;2;VR APG Rheintal;17996;144;180;-36;1043;999;44;-1;7;18003
2021;2771;Oberwil (BL);1301;Bezirk Arlesheim;4;VR BPA Leimental;4;VR BPA Leimental;11144;93;114;-21;861;781;80;0;59;11203
2021;2772;Pfeffingen;1301;Bezirk Arlesheim;3;VR Alter Birsstadt;3;VR Alter Birsstadt;2422;23;18;5;169;153;16;0;21;2443
2021;2773;Reinach (BL);1301;Bezirk Arlesheim;3;VR Alter Birsstadt;3;VR Alter Birsstadt;19248;127;186;-59;1394;1148;246;-1;186;19434
2021;2774;Schönenbuch;1301;Bezirk Arlesheim;1;VR Alter und Gesundheit ABS;1;VR Alter und Gesundheit ABS;1441;11;5;6;108;91;17;0;23;1464
2021;2775;Therwil;1301;Bezirk Arlesheim;4;VR BPA Leimental;4;VR BPA Leimental;10019;72;103;-31;709;629;80;0;49;10068
2021;2781;Blauen;1302;Bezirk Laufen;5;VR APG Laufental;5;VR APG Laufental;690;9;5;4;42;33;9;0;13;703
2021;2782;Brislach;1302;Bezirk Laufen;5;VR APG Laufental;5;VR APG Laufental;1695;16;10;6;109;76;33;0;39;1734
2021;2783;Burg im Leimental;1302;Bezirk Laufen;4;VR BPA Leimental;4;VR BPA Leimental;281;3;4;-1;12;17;-5;0;-6;275
2021;2784;Dittingen;1302;Bezirk Laufen;5;VR APG Laufental;5;VR APG Laufental;744;8;1;7;55;75;-20;0;-13;731
2021;2785;Duggingen;1302;Bezirk Laufen;3;VR Alter Birsstadt;3;VR Alter Birsstadt;1555;10;15;-5;168;119;49;0;44;1599
2021;2786;Grellingen;1302;Bezirk Laufen;5;VR APG Laufental;5;VR APG Laufental;1862;25;13;12;198;164;34;0;46;1908
2021;2787;Laufen;1302;Bezirk Laufen;5;VR APG Laufental;5;VR APG Laufental;5793;47;45;2;434;401;33;0;35;5828
2021;2788;Liesberg;1302;Bezirk Laufen;5;VR APG Laufental;5;VR APG Laufental;1112;2;13;-11;82;79;3;0;-8;1104
2021;2789;Nenzlingen;1302;Bezirk Laufen;5;VR APG Laufental;5;VR APG Laufental;447;5;1;4;58;45;13;0;17;464
2021;2790;Roggenburg;1302;Bezirk Laufen;5;VR APG Laufental;5;VR APG Laufental;270;2;1;1;11;11;0;0;1;271
2021;2791;Röschenz;1302;Bezirk Laufen;5;VR APG Laufental;5;VR APG Laufental;1904;14;11;3;112;124;-12;0;-9;1895
2021;2792;Wahlen;1302;Bezirk Laufen;5;VR APG Laufental;5;VR APG Laufental;1503;21;7;14;99;70;29;0;43;1546
2021;2793;Zwingen;1302;Bezirk Laufen;5;VR APG Laufental;5;VR APG Laufental;2520;45;15;30;311;250;61;0;91;2611
2021;2821;Arisdorf;1303;Bezirk Liestal;6;VR Alters- und Pflegeregion Liestal;6;VR Alters- und Pflegeregion Liestal;1699;17;10;7;105;101;4;0;11;1710
2021;2822;Augst;1303;Bezirk Liestal;2;VR APG Rheintal;2;VR APG Rheintal;1072;9;13;-4;84;103;-19;0;-23;1049
2021;2823;Bubendorf;1303;Bezirk Liestal;6;VR Alters- und Pflegeregion Liestal;6;VR Alters- und Pflegeregion Liestal;4363;48;36;12;257;260;-3;0;9;4372
2021;2824;Frenkendorf;1303;Bezirk Liestal;6;VR Alters- und Pflegeregion Liestal;6;VR Alters- und Pflegeregion Liestal;6517;58;44;14;483;481;2;0;16;6533
2021;2825;Füllinsdorf;1303;Bezirk Liestal;6;VR Alters- und Pflegeregion Liestal;6;VR Alters- und Pflegeregion Liestal;4591;44;48;-4;379;313;66;0;62;4653
2021;2826;Giebenach;1303;Bezirk Liestal;2;VR APG Rheintal;2;VR APG Rheintal;1090;16;7;9;93;72;21;0;30;1120
2021;2827;Hersberg;1303;Bezirk Liestal;6;VR Alters- und Pflegeregion Liestal;6;VR Alters- und Pflegeregion Liestal;350;4;6;-2;30;24;6;0;4;354
2021;2828;Lausen;1303;Bezirk Liestal;6;VR Alters- und Pflegeregion Liestal;6;VR Alters- und Pflegeregion Liestal;5472;58;37;21;630;385;245;0;266;5738
2021;2829;Liestal;1303;Bezirk Liestal;6;VR Alters- und Pflegeregion Liestal;6;VR Alters- und Pflegeregion Liestal;14798;137;127;10;1470;1139;331;0;341;15139
2021;2830;Lupsingen;1303;Bezirk Liestal;6;VR Alters- und Pflegeregion Liestal;6;VR Alters- und Pflegeregion Liestal;1451;7;8;-1;109;77;32;0;31;1482
2021;2831;Pratteln;1303;Bezirk Liestal;2;VR APG Rheintal;2;VR APG Rheintal;16686;177;145;32;1061;1236;-175;0;-143;16543
2021;2832;Ramlinsburg;1303;Bezirk Liestal;10;VR Waldenburgertal plus;8;VR Waldenburgertal plus;721;8;4;4;41;36;5;0;9;730
2021;2833;Seltisberg;1303;Bezirk Liestal;6;VR Alters- und Pflegeregion Liestal;6;VR Alters- und Pflegeregion Liestal;1311;5;11;-6;49;58;-9;0;-15;1296
2021;2834;Ziefen;1303;Bezirk Liestal;6;VR Alters- und Pflegeregion Liestal;6;VR Alters- und Pflegeregion Liestal;1646;10;14;-4;95;92;3;0;-1;1645
2021;2841;Anwil;1304;Bezirk Sissach;9;VR Farnsberg plus;7;Planungsregion Oberbaselbiet;542;4;10;-6;29;37;-8;0;-14;528
2021;2842;Böckten;1304;Bezirk Sissach;7;VR Oberbaselbiet;7;Planungsregion Oberbaselbiet;825;5;9;-4;46;47;-1;0;-5;820
2021;2843;Buckten;1304;Bezirk Sissach;8;VR Oberes Homburgertal;7;Planungsregion Oberbaselbiet;704;8;7;1;75;53;22;0;23;727
2021;2844;Buus;1304;Bezirk Sissach;9;VR Farnsberg plus;7;Planungsregion Oberbaselbiet;1094;12;12;0;91;58;33;0;33;1127
2021;2845;Diepflingen;1304;Bezirk Sissach;7;VR Oberbaselbiet;7;Planungsregion Oberbaselbiet;758;12;4;8;38;41;-3;0;5;763
2021;2846;Gelterkinden;1304;Bezirk Sissach;7;VR Oberbaselbiet;7;Planungsregion Oberbaselbiet;6225;64;56;8;433;457;-24;0;-16;6209
2021;2847;Häfelfingen;1304;Bezirk Sissach;8;VR Oberes Homburgertal;7;Planungsregion Oberbaselbiet;254;2;0;2;22;23;-1;0;1;255
2021;2848;Hemmiken;1304;Bezirk Sissach;9;VR Farnsberg plus;7;Planungsregion Oberbaselbiet;263;2;2;0;21;20;1;0;1;264
2021;2849;Itingen;1304;Bezirk Sissach;7;VR Oberbaselbiet;7;Planungsregion Oberbaselbiet;2190;15;18;-3;286;154;132;0;129;2319
2021;2850;Känerkinden;1304;Bezirk Sissach;8;VR Oberes Homburgertal;7;Planungsregion Oberbaselbiet;535;3;5;-2;21;35;-14;0;-16;519
2021;2851;Kilchberg (BL);1304;Bezirk Sissach;9;VR Farnsberg plus;7;Planungsregion Oberbaselbiet;171;1;0;1;19;27;-8;0;-7;164
2021;2852;Läufelfingen;1304;Bezirk Sissach;8;VR Oberes Homburgertal;7;Planungsregion Oberbaselbiet;1271;8;14;-6;98;82;16;0;10;1281
2021;2853;Maisprach;1304;Bezirk Sissach;9;VR Farnsberg plus;7;Planungsregion Oberbaselbiet;935;11;6;5;55;65;-10;0;-5;930
2021;2854;Nusshof;1304;Bezirk Sissach;7;VR Oberbaselbiet;7;Planungsregion Oberbaselbiet;260;2;0;2;13;12;1;0;3;263
2021;2855;Oltingen;1304;Bezirk Sissach;9;VR Farnsberg plus;7;Planungsregion Oberbaselbiet;509;3;4;-1;19;17;2;0;1;510
2021;2856;Ormalingen;1304;Bezirk Sissach;7;VR Oberbaselbiet;7;Planungsregion Oberbaselbiet;2285;28;18;10;187;168;19;0;29;2314
2021;2857;Rickenbach (BL);1304;Bezirk Sissach;9;VR Farnsberg plus;7;Planungsregion Oberbaselbiet;610;2;2;0;34;39;-5;0;-5;605
2021;2858;Rothenfluh;1304;Bezirk Sissach;9;VR Farnsberg plus;7;Planungsregion Oberbaselbiet;783;9;10;-1;51;63;-12;0;-13;770
2021;2859;Rümlingen;1304;Bezirk Sissach;8;VR Oberes Homburgertal;7;Planungsregion Oberbaselbiet;434;7;5;2;41;29;12;0;14;448
2021;2860;Rünenberg;1304;Bezirk Sissach;9;VR Farnsberg plus;7;Planungsregion Oberbaselbiet;762;2;7;-5;39;33;6;0;1;763
2021;2861;Sissach;1304;Bezirk Sissach;7;VR Oberbaselbiet;7;Planungsregion Oberbaselbiet;6713;65;61;4;534;425;109;0;113;6826
2021;2862;Tecknau;1304;Bezirk Sissach;7;VR Oberbaselbiet;7;Planungsregion Oberbaselbiet;834;7;5;2;51;72;-21;0;-19;815
2021;2863;Tenniken;1304;Bezirk Sissach;7;VR Oberbaselbiet;7;Planungsregion Oberbaselbiet;929;8;3;5;72;63;9;0;14;943
2021;2864;Thürnen;1304;Bezirk Sissach;7;VR Oberbaselbiet;7;Planungsregion Oberbaselbiet;1381;10;10;0;133;123;10;0;10;1391
2021;2865;Wenslingen;1304;Bezirk Sissach;7;VR Oberbaselbiet;7;Planungsregion Oberbaselbiet;697;3;6;-3;53;43;10;0;7;704
2021;2866;Wintersingen;1304;Bezirk Sissach;9;VR Farnsberg plus;7;Planungsregion Oberbaselbiet;639;5;3;2;43;41;2;0;4;643
2021;2867;Wittinsburg;1304;Bezirk Sissach;7;VR Oberbaselbiet;7;Planungsregion Oberbaselbiet;430;2;1;1;19;14;5;0;6;436
2021;2868;Zeglingen;1304;Bezirk Sissach;9;VR Farnsberg plus;7;Planungsregion Oberbaselbiet;495;6;2;4;48;30;18;0;22;517
2021;2869;Zunzgen;1304;Bezirk Sissach;7;VR Oberbaselbiet;7;Planungsregion Oberbaselbiet;2637;36;13;23;212;150;62;0;85;2722
2021;2881;Arboldswil;1305;Bezirk Waldenburg;10;VR Waldenburgertal plus;8;VR Waldenburgertal plus;564;5;4;1;46;28;18;0;19;583
2021;2882;Bennwil;1305;Bezirk Waldenburg;10;VR Waldenburgertal plus;8;VR Waldenburgertal plus;679;9;2;7;36;62;-26;0;-19;660
2021;2883;Bretzwil;1305;Bezirk Waldenburg;10;VR Waldenburgertal plus;8;VR Waldenburgertal plus;743;3;11;-8;55;35;20;0;12;755
2021;2884;Diegten;1305;Bezirk Waldenburg;7;VR Oberbaselbiet;7;Planungsregion Oberbaselbiet;1624;18;13;5;146;115;31;0;36;1660
2021;2885;Eptingen;1305;Bezirk Waldenburg;7;VR Oberbaselbiet;7;Planungsregion Oberbaselbiet;542;4;4;0;30;34;-4;0;-4;538
2021;2886;Hölstein;1305;Bezirk Waldenburg;10;VR Waldenburgertal plus;8;VR Waldenburgertal plus;2583;19;20;-1;289;239;50;0;49;2632
2021;2887;Lampenberg;1305;Bezirk Waldenburg;10;VR Waldenburgertal plus;8;VR Waldenburgertal plus;522;7;2;5;32;21;11;0;16;538
2021;2888;Langenbruck;1305;Bezirk Waldenburg;10;VR Waldenburgertal plus;8;VR Waldenburgertal plus;963;1;10;-9;75;67;8;0;-1;962
2021;2889;Lauwil;1305;Bezirk Waldenburg;10;VR Waldenburgertal plus;8;VR Waldenburgertal plus;310;5;1;4;32;28;4;0;8;318
2021;2890;Liedertswil;1305;Bezirk Waldenburg;10;VR Waldenburgertal plus;8;VR Waldenburgertal plus;156;1;1;0;1;3;-2;0;-2;154
2021;2891;Niederdorf;1305;Bezirk Waldenburg;10;VR Waldenburgertal plus;8;VR Waldenburgertal plus;1837;12;16;-4;159;180;-21;0;-25;1812
2021;2892;Oberdorf (BL);1305;Bezirk Waldenburg;10;VR Waldenburgertal plus;8;VR Waldenburgertal plus;2452;26;18;8;218;193;25;0;33;2485
2021;2893;Reigoldswil;1305;Bezirk Waldenburg;10;VR Waldenburgertal plus;8;VR Waldenburgertal plus;1592;13;22;-9;121;130;-9;0;-18;1574
2021;2894;Titterten;1305;Bezirk Waldenburg;10;VR Waldenburgertal plus;8;VR Waldenburgertal plus;422;1;1;0;46;41;5;0;5;427
2021;2895;Waldenburg;1305;Bezirk Waldenburg;10;VR Waldenburgertal plus;8;VR Waldenburgertal plus;1131;6;16;-10;110;100;10;0;0;1131
2022;2761;Aesch (BL);1301;Bezirk Arlesheim;3;VR Alter Birsstadt;3;VR Alter Birsstadt;10594;78;93;-15;855;712;143;0;128;10722
2022;2762;Allschwil;1301;Bezirk Arlesheim;1;VR Alter und Gesundheit ABS;1;VR Alter und Gesundheit ABS;21671;208;224;-16;1573;1325;248;0;232;21903
2022;2763;Arlesheim;1301;Bezirk Arlesheim;3;VR Alter Birsstadt;3;VR Alter Birsstadt;9248;52;123;-71;742;525;217;0;146;9394
2022;2764;Biel-Benken;1301;Bezirk Arlesheim;4;VR BPA Leimental;4;VR BPA Leimental;3606;19;34;-15;225;195;30;0;15;3621
2022;2765;Binningen;1301;Bezirk Arlesheim;1;VR Alter und Gesundheit ABS;1;VR Alter und Gesundheit ABS;15689;128;156;-28;1362;1154;208;0;180;15869
2022;2766;Birsfelden;1301;Bezirk Arlesheim;2;VR APG Rheintal;2;VR APG Rheintal;10400;86;144;-58;771;714;57;0;-1;10399
2022;2767;Bottmingen;1301;Bezirk Arlesheim;4;VR BPA Leimental;4;VR BPA Leimental;6976;55;79;-24;581;526;55;0;31;7007
2022;2768;Ettingen;1301;Bezirk Arlesheim;4;VR BPA Leimental;4;VR BPA Leimental;5561;41;55;-14;429;321;108;0;94;5655
2022;2769;Münchenstein;1301;Bezirk Arlesheim;3;VR Alter Birsstadt;3;VR Alter Birsstadt;12118;99;127;-28;1028;845;183;0;155;12273
2022;2770;Muttenz;1301;Bezirk Arlesheim;2;VR APG Rheintal;2;VR APG Rheintal;18003;138;184;-46;1134;943;191;0;145;18148
2022;2771;Oberwil (BL);1301;Bezirk Arlesheim;4;VR BPA Leimental;4;VR BPA Leimental;11203;89;94;-5;988;757;231;0;226;11429
2022;2772;Pfeffingen;1301;Bezirk Arlesheim;3;VR Alter Birsstadt;3;VR Alter Birsstadt;2443;11;20;-9;186;164;22;0;13;2456
2022;2773;Reinach (BL);1301;Bezirk Arlesheim;3;VR Alter Birsstadt;3;VR Alter Birsstadt;19434;145;221;-76;1603;1068;535;-1;458;19892
2022;2774;Schönenbuch;1301;Bezirk Arlesheim;1;VR Alter und Gesundheit ABS;1;VR Alter und Gesundheit ABS;1464;7;9;-2;108;76;32;0;30;1494
2022;2775;Therwil;1301;Bezirk Arlesheim;4;VR BPA Leimental;4;VR BPA Leimental;10068;64;114;-50;660;605;55;0;5;10073
2022;2781;Blauen;1302;Bezirk Laufen;5;VR APG Laufental;5;VR APG Laufental;703;4;5;-1;47;40;7;0;6;709
2022;2782;Brislach;1302;Bezirk Laufen;5;VR APG Laufental;5;VR APG Laufental;1734;14;15;-1;103;111;-8;0;-9;1725
2022;2783;Burg im Leimental;1302;Bezirk Laufen;4;VR BPA Leimental;4;VR BPA Leimental;275;3;6;-3;19;18;1;0;-2;273
2022;2784;Dittingen;1302;Bezirk Laufen;5;VR APG Laufental;5;VR APG Laufental;731;4;11;-7;84;65;19;0;12;743
2022;2785;Duggingen;1302;Bezirk Laufen;3;VR Alter Birsstadt;3;VR Alter Birsstadt;1599;12;15;-3;174;126;48;0;45;1644
2022;2786;Grellingen;1302;Bezirk Laufen;5;VR APG Laufental;5;VR APG Laufental;1908;18;21;-3;195;159;36;0;33;1941
2022;2787;Laufen;1302;Bezirk Laufen;5;VR APG Laufental;5;VR APG Laufental;5828;49;57;-8;559;375;184;0;176;6004
2022;2788;Liesberg;1302;Bezirk Laufen;5;VR APG Laufental;5;VR APG Laufental;1104;8;14;-6;93;99;-6;0;-12;1092
2022;2789;Nenzlingen;1302;Bezirk Laufen;5;VR APG Laufental;5;VR APG Laufental;464;5;0;5;35;29;6;0;11;475
2022;2790;Roggenburg;1302;Bezirk Laufen;5;VR APG Laufental;5;VR APG Laufental;271;3;3;0;14;18;-4;0;-4;267
2022;2791;Röschenz;1302;Bezirk Laufen;5;VR APG Laufental;5;VR APG Laufental;1895;11;11;0;135;130;5;0;5;1900
2022;2792;Wahlen;1302;Bezirk Laufen;5;VR APG Laufental;5;VR APG Laufental;1546;12;8;4;127;118;9;0;13;1559
2022;2793;Zwingen;1302;Bezirk Laufen;5;VR APG Laufental;5;VR APG Laufental;2611;32;15;17;318;209;109;0;126;2737
2022;2821;Arisdorf;1303;Bezirk Liestal;6;VR Alters- und Pflegeregion Liestal;6;VR Alters- und Pflegeregion Liestal;1710;11;16;-5;104;83;21;0;16;1726
2022;2822;Augst;1303;Bezirk Liestal;2;VR APG Rheintal;2;VR APG Rheintal;1049;8;10;-2;144;111;33;0;31;1080
2022;2823;Bubendorf;1303;Bezirk Liestal;6;VR Alters- und Pflegeregion Liestal;6;VR Alters- und Pflegeregion Liestal;4372;45;40;5;379;259;120;0;125;4497
2022;2824;Frenkendorf;1303;Bezirk Liestal;6;VR Alters- und Pflegeregion Liestal;6;VR Alters- und Pflegeregion Liestal;6533;49;59;-10;538;460;78;0;68;6601
2022;2825;Füllinsdorf;1303;Bezirk Liestal;6;VR Alters- und Pflegeregion Liestal;6;VR Alters- und Pflegeregion Liestal;4653;45;48;-3;395;348;47;0;44;4697
2022;2826;Giebenach;1303;Bezirk Liestal;2;VR APG Rheintal;2;VR APG Rheintal;1120;13;9;4;108;95;13;0;17;1137
2022;2827;Hersberg;1303;Bezirk Liestal;6;VR Alters- und Pflegeregion Liestal;6;VR Alters- und Pflegeregion Liestal;354;1;4;-3;27;12;15;0;12;366
2022;2828;Lausen;1303;Bezirk Liestal;6;VR Alters- und Pflegeregion Liestal;6;VR Alters- und Pflegeregion Liestal;5738;69;40;29;486;431;55;0;84;5822
2022;2829;Liestal;1303;Bezirk Liestal;6;VR Alters- und Pflegeregion Liestal;6;VR Alters- und Pflegeregion Liestal;15139;150;146;4;1638;1141;497;0;501;15640
2022;2830;Lupsingen;1303;Bezirk Liestal;6;VR Alters- und Pflegeregion Liestal;6;VR Alters- und Pflegeregion Liestal;1482;17;8;9;117;84;33;0;42;1524
2022;2831;Pratteln;1303;Bezirk Liestal;2;VR APG Rheintal;2;VR APG Rheintal;16543;170;173;-3;1388;1223;165;-1;161;16704
2022;2832;Ramlinsburg;1303;Bezirk Liestal;10;VR Waldenburgertal plus;8;VR Waldenburgertal plus;730;2;4;-2;62;36;26;0;24;754
2022;2833;Seltisberg;1303;Bezirk Liestal;6;VR Alters- und Pflegeregion Liestal;6;VR Alters- und Pflegeregion Liestal;1296;9;16;-7;98;65;33;0;26;1322
2022;2834;Ziefen;1303;Bezirk Liestal;6;VR Alters- und Pflegeregion Liestal;6;VR Alters- und Pflegeregion Liestal;1645;16;11;5;110;94;16;0;21;1666
2022;2841;Anwil;1304;Bezirk Sissach;9;VR Farnsberg plus;7;Planungsregion Oberbaselbiet;528;8;5;3;30;24;6;0;9;537
2022;2842;Böckten;1304;Bezirk Sissach;7;VR Oberbaselbiet;7;Planungsregion Oberbaselbiet;820;4;12;-8;80;65;15;0;7;827
2022;2843;Buckten;1304;Bezirk Sissach;8;VR Oberes Homburgertal;7;Planungsregion Oberbaselbiet;727;8;9;-1;64;58;6;0;5;732
2022;2844;Buus;1304;Bezirk Sissach;9;VR Farnsberg plus;7;Planungsregion Oberbaselbiet;1127;9;8;1;74;62;12;0;13;1140
2022;2845;Diepflingen;1304;Bezirk Sissach;7;VR Oberbaselbiet;7;Planungsregion Oberbaselbiet;763;7;6;1;67;44;23;0;24;787
2022;2846;Gelterkinden;1304;Bezirk Sissach;7;VR Oberbaselbiet;7;Planungsregion Oberbaselbiet;6209;50;58;-8;480;384;96;0;88;6297
2022;2847;Häfelfingen;1304;Bezirk Sissach;8;VR Oberes Homburgertal;7;Planungsregion Oberbaselbiet;255;3;3;0;14;7;7;0;7;262
2022;2848;Hemmiken;1304;Bezirk Sissach;9;VR Farnsberg plus;7;Planungsregion Oberbaselbiet;264;2;4;-2;25;17;8;0;6;270
2022;2849;Itingen;1304;Bezirk Sissach;7;VR Oberbaselbiet;7;Planungsregion Oberbaselbiet;2319;16;22;-6;215;180;35;0;29;2348
2022;2850;Känerkinden;1304;Bezirk Sissach;8;VR Oberes Homburgertal;7;Planungsregion Oberbaselbiet;519;3;5;-2;47;29;18;0;16;535
2022;2851;Kilchberg (BL);1304;Bezirk Sissach;9;VR Farnsberg plus;7;Planungsregion Oberbaselbiet;164;0;2;-2;26;15;11;0;9;173
2022;2852;Läufelfingen;1304;Bezirk Sissach;8;VR Oberes Homburgertal;7;Planungsregion Oberbaselbiet;1281;13;5;8;176;84;92;0;100;1381
2022;2853;Maisprach;1304;Bezirk Sissach;9;VR Farnsberg plus;7;Planungsregion Oberbaselbiet;930;9;13;-4;87;57;30;0;26;956
2022;2854;Nusshof;1304;Bezirk Sissach;7;VR Oberbaselbiet;7;Planungsregion Oberbaselbiet;263;1;6;-5;33;10;23;0;18;281
2022;2855;Oltingen;1304;Bezirk Sissach;9;VR Farnsberg plus;7;Planungsregion Oberbaselbiet;510;2;4;-2;39;16;23;0;21;531
2022;2856;Ormalingen;1304;Bezirk Sissach;7;VR Oberbaselbiet;7;Planungsregion Oberbaselbiet;2314;26;18;8;204;171;33;0;41;2355
2022;2857;Rickenbach (BL);1304;Bezirk Sissach;9;VR Farnsberg plus;7;Planungsregion Oberbaselbiet;605;4;6;-2;17;35;-18;0;-20;585
2022;2858;Rothenfluh;1304;Bezirk Sissach;9;VR Farnsberg plus;7;Planungsregion Oberbaselbiet;770;4;5;-1;91;55;36;0;35;805
2022;2859;Rümlingen;1304;Bezirk Sissach;8;VR Oberes Homburgertal;7;Planungsregion Oberbaselbiet;448;4;3;1;40;43;-3;0;-2;446
2022;2860;Rünenberg;1304;Bezirk Sissach;9;VR Farnsberg plus;7;Planungsregion Oberbaselbiet;763;6;4;2;72;49;23;0;25;788
2022;2861;Sissach;1304;Bezirk Sissach;7;VR Oberbaselbiet;7;Planungsregion Oberbaselbiet;6826;53;54;-1;559;479;80;0;79;6905
2022;2862;Tecknau;1304;Bezirk Sissach;7;VR Oberbaselbiet;7;Planungsregion Oberbaselbiet;815;6;4;2;64;52;12;0;14;829
2022;2863;Tenniken;1304;Bezirk Sissach;7;VR Oberbaselbiet;7;Planungsregion Oberbaselbiet;943;5;7;-2;75;96;-21;0;-23;920
2022;2864;Thürnen;1304;Bezirk Sissach;7;VR Oberbaselbiet;7;Planungsregion Oberbaselbiet;1391;16;11;5;188;129;59;0;64;1455
2022;2865;Wenslingen;1304;Bezirk Sissach;7;VR Oberbaselbiet;7;Planungsregion Oberbaselbiet;704;5;9;-4;42;32;10;0;6;710
2022;2866;Wintersingen;1304;Bezirk Sissach;9;VR Farnsberg plus;7;Planungsregion Oberbaselbiet;643;4;5;-1;34;57;-23;0;-24;619
2022;2867;Wittinsburg;1304;Bezirk Sissach;7;VR Oberbaselbiet;7;Planungsregion Oberbaselbiet;436;2;4;-2;31;32;-1;0;-3;433
2022;2868;Zeglingen;1304;Bezirk Sissach;9;VR Farnsberg plus;7;Planungsregion Oberbaselbiet;517;1;5;-4;23;26;-3;0;-7;510
2022;2869;Zunzgen;1304;Bezirk Sissach;7;VR Oberbaselbiet;7;Planungsregion Oberbaselbiet;2722;29;27;2;213;189;24;0;26;2748
2022;2881;Arboldswil;1305;Bezirk Waldenburg;10;VR Waldenburgertal plus;8;VR Waldenburgertal plus;583;4;7;-3;32;16;16;0;13;596
2022;2882;Bennwil;1305;Bezirk Waldenburg;10;VR Waldenburgertal plus;8;VR Waldenburgertal plus;660;5;5;0;69;54;15;0;15;675
2022;2883;Bretzwil;1305;Bezirk Waldenburg;10;VR Waldenburgertal plus;8;VR Waldenburgertal plus;755;4;7;-3;46;46;0;0;-3;752
2022;2884;Diegten;1305;Bezirk Waldenburg;7;VR Oberbaselbiet;7;Planungsregion Oberbaselbiet;1660;19;12;7;126;139;-13;0;-6;1654
2022;2885;Eptingen;1305;Bezirk Waldenburg;7;VR Oberbaselbiet;7;Planungsregion Oberbaselbiet;538;4;5;-1;72;38;34;0;33;571
2022;2886;Hölstein;1305;Bezirk Waldenburg;10;VR Waldenburgertal plus;8;VR Waldenburgertal plus;2632;29;15;14;228;195;33;0;47;2679
2022;2887;Lampenberg;1305;Bezirk Waldenburg;10;VR Waldenburgertal plus;8;VR Waldenburgertal plus;538;5;4;1;33;19;14;0;15;553
2022;2888;Langenbruck;1305;Bezirk Waldenburg;10;VR Waldenburgertal plus;8;VR Waldenburgertal plus;962;6;9;-3;113;84;29;0;26;988
2022;2889;Lauwil;1305;Bezirk Waldenburg;10;VR Waldenburgertal plus;8;VR Waldenburgertal plus;318;0;4;-4;9;4;5;0;1;319
2022;2890;Liedertswil;1305;Bezirk Waldenburg;10;VR Waldenburgertal plus;8;VR Waldenburgertal plus;154;0;4;-4;11;4;7;0;3;157
2022;2891;Niederdorf;1305;Bezirk Waldenburg;10;VR Waldenburgertal plus;8;VR Waldenburgertal plus;1812;22;14;8;193;191;2;0;10;1822
2022;2892;Oberdorf (BL);1305;Bezirk Waldenburg;10;VR Waldenburgertal plus;8;VR Waldenburgertal plus;2485;17;25;-8;174;196;-22;0;-30;2455
2022;2893;Reigoldswil;1305;Bezirk Waldenburg;10;VR Waldenburgertal plus;8;VR Waldenburgertal plus;1574;19;20;-1;130;116;14;0;13;1587
2022;2894;Titterten;1305;Bezirk Waldenburg;10;VR Waldenburgertal plus;8;VR Waldenburgertal plus;427;1;4;-3;22;26;-4;0;-7;420
2022;2895;Waldenburg;1305;Bezirk Waldenburg;10;VR Waldenburgertal plus;8;VR Waldenburgertal plus;1131;8;11;-3;131;141;-10;0;-13;1118
